localAuth_wardNumber	ZAPU	ZANU_PF	ZDP	MDC	MDC_T	rejected_votes	unaccounted_ballot	total_votes	total_valid_votes
1**Beitbridge RDC	10	861	10	24	101	67	0	1073	1006
1**Beitbridge Town Council	7	515	0	23	431	15	0	991	976
1**Bikita RDC	13	781	5	19	250	39	0	1107	1068
1**Bindura Municipality	2	1044	0	9	906	17	0	1978	1961
1**Bindura RDC	3	2287	1	0	27	18	2	2336	2318
1**Binga RDC	15	512	5	75	457	64	0	1128	1064
1**Bubi RDC	9	901	0	20	118	34	0	1082	1048
1**Buhera RDC	12	999	3	66	600	26	0	1706	1680
1**Bulawayo City Council	24	743	0	179	1369	12	0	2327	2315
1**Bulilima RDC	14	427	13	56	523	25	0	1058	1033
1**Chaminuka RDC	5	1432	2	23	141	17	0	1620	1603
1**Chegutu Municipality	1	119	2	2	210	4	0	338	334
1**Chegutu RDC	8	1258	5	63	589	27	0	1950	1923
1**Chikomba RDC	11	1111	3	5	118	35	0	1283	1248
1**Chimanimani RDC	10	1501	2	6	222	29	0	1770	1741
1**Chinhoyi Municipality	0	232	0	8	303	8	0	551	543
1**Chipinge RDC	10	1429	2	55	897	48	0	2441	2393
1**Chipinge Town Council	4	309	0	6	415	10	0	744	734
1**Chiredzi RDC	7	1087	6	37	399	26	0	1562	1536
1**Chitungwiza Municipality	0	786	3	40	946	23	0	1798	1775
1**Chivi RDC	6	1035	7	46	569	44	0	1707	1663
1**Epworth Local Board	7	2357	4	60	2058	85	0	4571	4486
1**Gokwe North RDC	12	484	6	63	573	52	0	1190	1138
1**Gokwe South RDC	38	1931	14	75	502	125	0	2685	2560
1**Gokwe Town Council	0	242	1	3	238	5	0	489	484
1**Goromonzi RDC	21	1342	9	63	1227	59	0	2721	2662
1**Guruve RDC	16	3434	4	10	85	43	0	3592	3549
1**Gutu RDC	17	3762	1	13	173	31	0	3997	3966
1**Gwanda Municipality	2	284	0	23	259	4	0	572	568
1**Gwanda R.D.C	11	414	9	124	655	19	0	1232	1213
1**Gweru Municipality	0	453	3	27	934	10	0	1427	1417
1**Harare Municipality	74	19164	31	422	9519	624	0	29834	29210
1**Hurungwe RDC	19	2367	9	17	271	60	0	2743	2683
1**Hwange Local Board	0	145	0	9	338	15	0	507	492
1**Hwange RDC	8	1106	3	26	133	40	0	1316	1276
1**Insiza RDC	15	362	13	161	420	15	0	986	971
1**Kadoma City Council	5	789	0	12	566	40	0	1412	1372
1**Kariba Municipality	1	707	0	18	969	37	0	1732	1695
1**Karoi Town Council	1	326	1	9	247	14	0	598	584
1**Kusile RDC	6	267	8	72	252	9	0	614	605
1**Kwekwe Municipality	3	980	4	43	1578	23	0	2631	2605
1**Makonde RDC	15	2415	1	2	40	28	0	2501	2473
1**Makoni RDC	13	871	9	26	311	26	0	1256	1230
1**Mangwe RDC	15	415	11	50	327	8	0	826	818
1**Manyame RDC	11	1272	3	69	1334	29	4	2718	2689
1**Marondera Municipality	2	984	2	20	709	12	1	1729	1717
1**Marondera RDC	6	1458	2	6	221	16	1	1709	1693
1**Masvingo Municipality	3	791	1	22	754	31	0	1602	1571
1**Masvingo RDC	10	806	8	73	618	44	0	1559	1515
1**Matobo RDC	20	373	11	70	450	17	0	941	924
1**Mazowe RDC	20	974	10	26	197	36	0	1263	1227
1**Mberengwa RDC	11	1208	2	15	116	25	0	1377	1352
1**Mbire RDC	12	690	5	29	169	20	0	925	905
1**Mhondoro-Ngezi RDC	6	986	2	20	447	33	0	1494	1461
1**Mudzi RDC	11	2089	2	28	509	28	0	2667	2639
1**Murewa RDC	13	1173	8	25	223	24	0	1466	1442
1**Mutare Municipality	4	673	3	47	1832	23	0	2582	2559
1**Mutare RDC	20	2624	4	37	544	92	0	3321	3229
1**Mutasa RDC	14	926	9	65	800	75	0	1889	1814
1**Mutoko RDC	15	1536	0	8	147	15	0	1721	1706
1**Muzarabani RDC	9	1982	1	12	93	39	0	2136	2097
1**Mwenezi RDC	12	793	1	51	313	59	0	1229	1170
1**Nkayi RDC	19	413	8	119	412	41	0	1012	971
1**Norton Town Council	2	346	1	279	468	14	0	1110	1096
1**Nyaminyami RDC	1	323	0	6	118	2	0	450	448
1**Nyanga RDC	14	750	2	32	413	51	0	1262	1211
1**Pfura RDC	5	1080	1	4	59	38	0	1187	1149
1**Plumtree Town Council	9	335	1	55	467	22	0	889	867
1**Redcliff Municipality	1	228	1	20	495	6	0	751	745
1**Runde RDC	3	430	0	20	161	7	0	621	614
1**Rusape Town Council	2	400	1	16	521	12	0	952	940
1**Rushinga RDC	3	1018	1	3	17	27	0	1069	1042
1**Ruwa Local Board	2	519	0	13	1105	9	0	1648	1639
1**Sanyati RDC	16	2945	3	7	191	116	0	3278	3162
1**Shurugwi Town Council	0	170	0	2	143	8	0	323	315
1**Takawira RDC	12	705	3	37	450	29	0	1236	1207
1**Tongogara RDC	16	1051	0	5	165	47	0	1284	1237
1**Tsholotsho RDC	10	315	7	120	393	22	0	867	845
1**Umguza RDC	27	589	3	84	472	30	0	1205	1175
1**Umzingwane RDC	17	546	6	41	334	14	0	958	944
1**Victoria Falls Municipality	3	110	1	8	217	0	0	339	339
1**Vungu RDC	29	1000	7	194	114	12	0	1356	1344
1**Wedza RDC	10	1797	4	8	79	26	0	1924	1898
1**Zaka RDC	12	738	2	29	345	55	0	1181	1126
1**Zibagwe RDC	5	1958	2	2	57	57	0	2081	2024
1**Zvataida RDC	14	2251	3	9	63	17	0	2357	2340
1**Zvimba RDC	15	1388	4	36	295	28	0	1766	1738
1**Zvishavane Town Council	2	398	0	19	354	13	0	786	773
10**Beitbridge RDC	20	986	9	49	319	63	0	1446	1383
10**Bikita RDC	18	1213	7	35	321	63	0	1657	1594
10**Bindura Municipality	1	472	0	29	735	15	0	1252	1237
10**Bindura RDC	15	1058	7	49	422	38	0	1589	1551
10**Binga RDC	5	191	6	63	1047	77	0	1389	1312
10**Bubi RDC	9	373	1	20	236	22	0	661	639
10**Buhera RDC	25	1715	2	74	701	40	0	2557	2517
10**Bulawayo City Council	62	1277	14	365	3905	54	0	5677	5623
10**Bulilima RDC	6	519	5	176	230	24	0	960	936
10**Chaminuka RDC	8	1160	1	12	109	33	0	1323	1290
10**Chegutu Municipality	0	548	1	10	776	17	0	1352	1335
10**Chegutu RDC	22	1408	8	95	839	65	0	2437	2372
10**Chikomba RDC	3	544	0	11	276	10	0	844	834
10**Chimanimani RDC	11	570	1	24	112	22	0	740	718
10**Chinhoyi Municipality	0	369	0	7	455	3	0	834	831
10**Chipinge RDC	8	971	4	13	179	25	0	1200	1175
10**Chiredzi RDC	28	1771	3	27	256	37	0	2122	2085
10**Chitungwiza Municipality	0	825	3	30	1460	20	0	2338	2318
10**Chivi RDC	17	1007	2	14	195	41	0	1276	1235
10**Gokwe North RDC	36	1906	12	37	248	135	0	2374	2239
10**Gokwe South RDC	27	1784	12	85	929	81	0	2918	2837
10**Goromonzi RDC	8	1271	4	33	397	29	0	1742	1713
10**Guruve RDC	5	842	5	30	190	26	0	1098	1072
10**Gutu RDC	23	1079	10	78	542	20	0	1752	1732
10**Gwanda Municipality	5	127	1	13	151	4	0	301	297
10**Gwanda R.D.C	0	19	2	13	29	0	0	63	63
10**Gweru Municipality	5	669	1	25	1631	22	0	2353	2331
10**Harare Municipality	9	1495	2	79	3976	39	0	5600	5561
10**Hurungwe RDC	16	2624	8	56	718	45	1	3467	3422
10**Hwange Local Board	1	140	1	17	657	16	0	832	816
10**Hwange RDC	26	488	15	78	936	69	0	1612	1543
10**Insiza RDC	11	193	2	63	240	15	0	524	509
10**Kadoma City Council	6	804	0	27	955	36	0	1828	1792
10**Karoi Town Council	5	619	1	22	621	41	0	1309	1268
10**Kusile RDC	16	309	15	160	595	27	0	1122	1095
10**Kwekwe Municipality	7	579	0	42	901	32	0	1561	1529
10**Makonde RDC	3	719	1	12	174	5	0	914	909
10**Makoni RDC	11	932	4	43	484	33	0	1507	1474
10**Mangwe RDC	18	302	19	145	317	42	0	843	801
10**Manyame RDC	11	1198	7	18	432	25	0	1691	1666
10**Marondera Municipality	4	838	2	22	971	20	0	1857	1837
10**Marondera RDC	13	611	4	49	566	44	0	1287	1243
10**Masvingo Municipality	3	2804	3	10	755	73	0	3648	3575
10**Masvingo RDC	16	1450	3	31	510	30	0	2040	2010
10**Matobo RDC	8	390	3	38	418	13	0	870	857
10**Mazowe RDC	12	1305	5	53	607	79	0	2061	1982
10**Mberengwa RDC	8	625	3	40	289	22	0	987	965
10**Mbire RDC	9	2102	1	38	210	46	0	2406	2360
10**Mhondoro-Ngezi RDC	4	1253	1	8	122	21	0	1409	1388
10**Mudzi RDC	15	2553	8	42	602	32	0	3252	3220
10**Murewa RDC	8	1513	3	18	198	30	0	1770	1740
10**Mutare Municipality	2	697	1	9	648	10	0	1367	1357
10**Mutare RDC	22	1462	6	92	568	32	0	2182	2150
10**Mutasa RDC	11	292	8	56	862	17	0	1246	1229
10**Mutoko RDC	6	1422	4	20	167	29	0	1648	1619
10**Muzarabani RDC	16	1668	4	16	155	44	0	1903	1859
10**Mwenezi RDC	36	1533	4	36	152	45	0	1806	1761
10**Nkayi RDC	14	360	10	48	314	44	0	790	746
10**Norton Town Council	2	751	1	21	1205	21	0	2001	1980
10**Nyaminyami RDC	2	595	0	1	30	8	0	636	628
10**Nyanga RDC	12	662	2	35	463	16	0	1190	1174
10**Pfura RDC	16	3003	5	20	206	50	0	3300	3250
10**Runde RDC	6	827	1	26	305	26	0	1191	1165
10**Rusape Town Council	1	509	0	13	510	10	0	1043	1033
10**Rushinga RDC	12	1696	7	18	124	41	0	1898	1857
10**Sanyati RDC	6	1061	5	31	347	26	0	1476	1450
10**Shurugwi Town Council	4	386	0	5	130	9	0	534	525
10**Takawira RDC	3	453	2	9	134	8	0	609	601
10**Tongogara RDC	12	953	12	52	643	33	0	1705	1672
10**Tsholotsho RDC	37	348	8	83	344	16	0	836	820
10**Umguza RDC	12	442	5	37	107	23	0	626	603
10**Umzingwane RDC	3	192	2	64	159	11	0	431	420
10**Victoria Falls Municipality	6	302	2	24	388	8	0	730	722
10**Vungu RDC	7	408	2	21	444	18	0	900	882
10**Wedza RDC	11	788	0	28	211	10	0	1048	1038
10**Zaka RDC	11	1169	4	49	331	21	0	1585	1564
10**Zibagwe RDC	14	1085	5	81	793	40	0	2018	1978
10**Zvataida RDC	18	2417	3	7	42	28	0	2515	2487
10**Zvimba RDC	8	687	7	28	192	16	0	938	922
10**Zvishavane Town Council	1	486	3	40	967	29	0	1526	1497
11**Beitbridge RDC	30	1161	17	59	265	67	0	1599	1532
11**Bikita RDC	10	1314	13	54	577	65	0	2033	1968
11**Bindura Municipality	3	521	0	17	462	27	0	1030	1003
11**Bindura RDC	7	955	2	32	353	17	0	1366	1349
11**Binga RDC	7	391	14	52	780	68	0	1312	1244
11**Bubi RDC	30	665	11	74	589	38	0	1407	1369
11**Buhera RDC	9	1087	5	31	531	74	0	1737	1663
11**Bulawayo City Council	44	811	1	354	2392	25	0	3627	3602
11**Bulilima RDC	12	503	18	115	400	18	0	1066	1048
11**Chaminuka RDC	19	1398	5	19	158	116	1	1715	1599
11**Chegutu Municipality	1	539	2	20	1082	28	0	1672	1644
11**Chegutu RDC	12	1676	4	15	192	16	0	1915	1899
11**Chikomba RDC	1	459	0	7	303	8	0	778	770
11**Chimanimani RDC	0	453	0	1	25	37	0	516	479
11**Chinhoyi Municipality	6	439	1	5	426	12	0	889	877
11**Chipinge RDC	10	679	3	14	90	21	0	817	796
11**Chiredzi RDC	54	1952	17	62	469	63	0	2617	2554
11**Chitungwiza Municipality	2	687	1	23	1261	12	0	1986	1974
11**Chivi RDC	10	1068	3	17	288	23	0	1409	1386
11**Gokwe North RDC	11	1526	12	50	620	66	1	2285	2219
11**Gokwe South RDC	30	1744	14	88	930	72	0	2878	2806
11**Goromonzi RDC	13	1573	15	71	707	63	0	2442	2379
11**Guruve RDC	26	1744	8	41	254	55	0	2128	2073
11**Gutu RDC	30	1321	11	77	431	31	0	1901	1870
11**Gwanda R.D.C	35	570	12	103	540	36	0	1296	1260
11**Gweru Municipality	0	573	0	31	1036	8	0	1648	1640
11**Harare Municipality	12	2214	2	105	3396	83	0	5812	5729
11**Hurungwe RDC	53	1875	16	91	1190	92	0	3317	3225
11**Hwange Local Board	2	116	2	32	1251	23	0	1426	1403
11**Hwange RDC	0	379	2	30	339	31	0	781	750
11**Insiza RDC	10	228	10	162	195	10	0	615	605
11**Kadoma City Council	4	892	1	23	984	31	0	1935	1904
11**Kusile RDC	13	488	8	76	507	30	0	1122	1092
11**Kwekwe Municipality	6	1199	2	48	1177	57	0	2489	2432
11**Makonde RDC	31	2671	2	31	694	48	0	3477	3429
11**Makoni RDC	12	1160	2	15	314	23	0	1526	1503
11**Mangwe RDC	28	611	4	21	80	14	7	758	744
11**Manyame RDC	3	134	1	8	142	3	0	291	288
11**Marondera Municipality	1	297	1	4	230	6	0	539	533
11**Marondera RDC	8	1039	7	60	561	49	1	1724	1675
11**Masvingo RDC	7	572	2	29	331	30	0	971	941
11**Matobo RDC	10	438	3	36	328	15	0	830	815
11**Mazowe RDC	20	1498	5	62	586	47	0	2218	2171
11**Mberengwa RDC	6	724	5	34	304	24	0	1097	1073
11**Mbire RDC	11	604	2	1	13	13	0	644	631
11**Mhondoro-Ngezi RDC	14	2016	1	40	935	73	0	3079	3006
11**Mudzi RDC	10	1840	4	39	323	55	0	2271	2216
11**Murewa RDC	36	1811	11	94	786	39	0	2777	2738
11**Mutare Municipality	3	768	1	19	1763	23	0	2577	2554
11**Mutare RDC	23	1285	6	84	613	70	0	2081	2011
11**Mutasa RDC	16	1091	13	143	1548	55	0	2866	2811
11**Mutoko RDC	13	1692	5	31	447	69	0	2257	2188
11**Muzarabani RDC	3	1106	1	2	36	18	0	1166	1148
11**Mwenezi RDC	20	1491	3	10	73	80	0	1677	1597
11**Nkayi RDC	10	191	5	28	259	28	0	521	493
11**Norton Town Council	0	592	0	14	868	11	0	1485	1474
11**Nyaminyami RDC	5	991	3	7	51	19	0	1076	1057
11**Nyanga RDC	4	704	3	37	428	33	0	1209	1176
11**Pfura RDC	21	2213	8	15	107	27	0	2391	2364
11**Runde RDC	2	596	4	17	347	17	0	983	966
11**Rushinga RDC	3	1091	4	4	44	5	0	1151	1146
11**Sanyati RDC	7	1411	4	39	625	35	0	2121	2086
11**Shurugwi Town Council	2	391	2	11	223	6	0	635	629
11**Takawira RDC	11	864	3	18	232	52	0	1180	1128
11**Tongogara RDC	8	846	4	36	538	43	0	1475	1432
11**Tsholotsho RDC	102	129	7	50	204	9	0	501	492
11**Umguza RDC	20	384	8	118	648	54	0	1232	1178
11**Umzingwane RDC	5	319	1	43	242	16	0	626	610
11**Victoria Falls Municipality	20	731	4	128	1503	34	0	2420	2386
11**Vungu RDC	10	846	10	52	693	29	0	1640	1611
11**Wedza RDC	11	771	3	34	260	17	0	1096	1079
11**Zaka RDC	30	922	11	72	467	53	0	1555	1502
11**Zibagwe RDC	41	856	12	61	520	30	0	1520	1490
11**Zvataida RDC	17	2912	4	7	58	14	0	3012	2998
11**Zvimba RDC	4	896	6	23	157	12	0	1098	1086
12**Beitbridge RDC	31	1025	14	54	334	81	0	1539	1458
12**Bikita RDC	7	917	5	41	383	41	0	1394	1353
12**Bindura Municipality	3	854	1	16	746	28	0	1648	1620
12**Bindura RDC	8	1049	2	25	213	15	0	1312	1297
12**Binga RDC	10	304	7	35	605	24	0	985	961
12**Bubi RDC	27	649	5	42	170	23	0	916	893
12**Buhera RDC	9	1356	5	61	638	92	0	2161	2069
12**Bulawayo City Council	64	1150	4	269	3329	42	0	4858	4816
12**Bulilima RDC	17	399	14	181	407	36	0	1054	1018
12**Chaminuka RDC	11	1477	2	16	135	51	0	1692	1641
12**Chegutu Municipality	9	891	4	26	1506	76	0	2512	2436
12**Chegutu RDC	7	1475	0	7	56	32	0	1577	1545
12**Chikomba RDC	2	461	1	4	263	10	0	741	731
12**Chimanimani RDC	7	853	4	31	380	29	0	1304	1275
12**Chinhoyi Municipality	1	628	0	16	858	14	0	1517	1503
12**Chipinge RDC	12	1202	6	35	304	57	0	1616	1559
12**Chiredzi RDC	1	129	0	8	44	2	0	184	182
12**Chitungwiza Municipality	6	977	5	70	1796	23	0	2877	2854
12**Chivi RDC	13	1061	5	39	431	31	0	1580	1549
12**Gokwe North RDC	12	1614	11	36	353	36	0	2062	2026
12**Gokwe South RDC	21	1517	19	108	842	90	0	2597	2507
12**Goromonzi RDC	20	2062	12	98	963	47	0	3202	3155
12**Guruve RDC	21	1851	9	36	218	52	0	2187	2135
12**Gutu RDC	29	1099	13	89	795	53	0	2078	2025
12**Gwanda RDC	28	667	12	99	720	13	0	1539	1526
12**Gweru Municipality	3	627	1	25	1267	27	0	1950	1923
12**Harare Municipality	8	1549	6	107	3743	49	0	5462	5413
12**Hurungwe RDC	24	1666	9	59	758	58	0	2574	2516
12**Hwange Local Board	1	103	3	13	775	4	0	899	895
12**Hwange RDC	2	138	2	22	589	30	0	783	753
12**Insiza RDC	19	360	6	225	312	5	0	927	922
12**Kadoma City Council	2	753	1	26	625	20	0	1427	1407
12**Kusile RDC	15	445	11	125	327	11	0	934	923
12**Kwekwe Municipality	6	640	2	45	974	19	0	1686	1667
12**Makonde RDC	2	343	2	10	172	7	0	536	529
12**Makoni RDC	26	1326	8	120	1161	79	0	2720	2641
12**Mangwe RDC	6	238	5	30	302	17	0	598	581
12**Manyame RDC	10	673	2	11	128	22	0	846	824
12**Marondera Municipality	2	790	1	20	882	15	1	1710	1695
12**Marondera RDC	14	901	13	60	418	32	0	1438	1406
12**Masvingo RDC	24	1427	7	91	918	53	0	2520	2467
12**Matobo RDC	46	451	7	75	430	28	0	1037	1009
12**Mazowe RDC	14	1249	6	61	742	61	0	2133	2072
12**Mberengwa RDC	13	1106	0	22	279	26	0	1446	1420
12**Mbire RDC	33	1523	8	36	386	116	0	2102	1986
12**Mhondoro-Ngezi RDC	11	2055	3	13	205	48	0	2335	2287
12**Mudzi RDC	25	2812	14	32	330	118	0	3331	3213
12**Murewa RDC	15	1518	13	91	842	66	0	2545	2479
12**Mutare Municipality	11	2553	4	39	2307	50	0	4964	4914
12**Mutare RDC	16	1158	7	69	593	41	0	1884	1843
12**Mutasa RDC	10	705	9	87	1094	35	0	1940	1905
12**Mutoko RDC	7	1236	3	26	221	19	0	1512	1493
12**Muzarabani RDC	5	1507	3	2	22	12	0	1551	1539
12**Mwenezi RDC	11	1212	3	8	40	12	0	1286	1274
12**Nkayi RDC	25	340	8	75	497	25	0	970	945
12**Norton Town Council	3	1056	1	32	1154	25	0	2271	2246
12**Nyaminyami RDC	3	1485	6	21	216	32	0	1763	1731
12**Nyanga RDC	7	730	4	62	616	13	0	1432	1419
12**Pfura RDC	21	2139	4	17	122	18	0	2321	2303
12**Runde RDC	4	616	2	43	410	22	0	1097	1075
12**Rushinga RDC	8	1718	1	12	132	32	0	1903	1871
12**Sanyati RDC	9	1309	7	33	612	38	0	2008	1970
12**Shurugwi Town Council	3	179	1	14	174	10	0	381	371
12**Takawira RDC	7	1991	5	15	134	76	0	2228	2152
12**Tongogara RDC	5	583	1	27	432	40	0	1088	1048
12**Tsholotsho RDC	73	410	20	231	629	35	0	1398	1363
12**Umguza RDC	9	351	5	39	161	11	0	576	565
12**Umzingwane RDC	13	301	9	82	619	32	0	1056	1024
12**Vungu RDC	8	570	4	45	603	26	0	1256	1230
12**Wedza RDC	13	857	4	38	332	11	0	1255	1244
12**Zaka RDC	22	799	14	45	295	43	0	1218	1175
12**Zibagwe RDC	12	823	10	38	579	36	0	1498	1462
12**Zvataida RDC	18	2276	4	34	150	41	1	2523	2482
12**Zvimba RDC	9	979	6	18	205	22	0	1239	1217
13**Beitbridge RDC	9	656	2	4	31	13	0	715	702
13**Bikita RDC	12	1278	9	66	1023	69	0	2457	2388
13**Bindura RDC	8	710	1	28	264	14	0	1025	1011
13**Binga RDC	8	439	13	48	899	58	0	1465	1407
13**Bubi RDC	30	524	4	37	91	21	0	707	686
13**Buhera RDC	9	1530	2	43	787	46	0	2417	2371
13**Bulawayo City Council	50	1006	4	236	3047	55	0	4398	4343
13**Bulilima RDC	24	173	11	72	368	32	0	680	648
13**Chaminuka RDC	5	1237	0	6	59	13	0	1320	1307
13**Chegutu RDC	2	635	3	12	140	14	0	806	792
13**Chikomba RDC	0	69	0	2	51	1	0	123	122
13**Chimanimani RDC	33	1564	11	58	390	58	0	2114	2056
13**Chinhoyi Municipality	2	553	0	17	739	12	0	1323	1311
13**Chipinge RDC	24	1855	19	49	320	62	0	2329	2267
13**Chiredzi RDC	50	1090	24	60	192	77	0	1493	1416
13**Chitungwiza Municipality	8	812	0	39	1456	19	0	2334	2315
13**Chivi RDC	12	739	2	34	381	24	0	1192	1168
13**Gokwe North RDC	20	2225	15	66	1042	73	0	3441	3368
13**Gokwe South RDC	24	1665	14	102	808	57	0	2670	2613
13**Goromonzi RDC	4	634	0	7	99	15	164	759	744
13**Guruve RDC	18	2332	2	8	54	39	0	2453	2414
13**Gutu RDC	26	1295	18	110	625	35	0	2109	2074
13**Gwanda Rural	28	737	17	456	588	31	0	1857	1826
13**Gweru Municipality	6	784	0	35	1596	10	0	2431	2421
13**Harare Municipality	3	1130	2	73	4267	79	0	5554	5475
13**Hurungwe RDC	74	2920	21	148	1218	121	0	4502	4381
13**Hwange Local Board	1	115	0	28	1118	28	0	1290	1262
13**Hwange RDC	1	249	2	20	376	22	0	670	648
13**Insiza RDC	27	685	5	35	233	31	0	1016	985
13**Kadoma City Council	3	821	1	13	749	53	0	1640	1587
13**Kusile RDC	24	480	14	121	610	24	0	1273	1249
13**Kwekwe Municipality	3	587	0	18	687	12	0	1307	1295
13**Makonde RDC	2	1534	0	8	71	25	0	1640	1615
13**Makoni RDC	0	237	0	9	169	6	0	421	415
13**Mangwe RDC	17	256	9	75	454	19	0	830	811
13**Manyame RDC	2	418	1	6	192	5	0	624	619
13**Marondera RDC	3	762	4	26	228	25	0	1048	1023
13**Masvingo RDC	20	1292	5	40	582	49	0	1988	1939
13**Matobo RDC	16	634	4	54	344	22	0	1074	1052
13**Mazowe RDC	21	1466	11	55	541	66	0	2160	2094
13**Mberengwa RDC	15	538	2	63	475	27	0	1120	1093
13**Mbire RDC	6	933	2	10	112	52	0	1115	1063
13**Mhondoro-Ngezi RDC	29	6177	8	27	578	168	0	6987	6819
13**Mudzi RDC	10	1669	4	19	144	67	0	1913	1846
13**Murewa RDC	7	930	2	35	496	21	0	1491	1470
13**Mutare Municipality	3	347	1	6	439	6	0	802	796
13**Mutare RDC	17	922	7	44	540	43	0	1573	1530
13**Mutasa RDC	5	607	4	52	817	39	0	1524	1485
13**Mutoko RDC	8	1137	3	22	244	9	0	1423	1414
13**Muzarabani RDC	9	1008	0	4	24	13	0	1058	1045
13**Mwenezi RDC	85	8332	12	40	298	130	0	8897	8767
13**Nkayi RDC	8	213	3	22	224	13	0	483	470
13**Norton Town Council	1	653	0	23	1002	37	0	1716	1679
13**Nyanga RDC	10	646	6	26	239	32	0	959	927
13**Pfura RDC	2	400	0	9	127	10	0	548	538
13**Runde RDC	11	827	2	32	421	34	0	1327	1293
13**Rushinga RDC	8	1310	3	8	134	38	0	1501	1463
13**Sanyati RDC	2	258	0	5	39	2	0	306	304
13**Shurugwi Town Council	2	391	2	11	223	6	0	635	629
13**Takawira RDC	1	350	1	6	282	13	0	653	640
13**Tongogara RDC	8	843	5	51	536	39	0	1482	1443
13**Tsholotsho RDC	18	290	5	81	519	23	0	936	913
13**Umguza RDC	8	580	0	13	61	9	0	671	662
13**Umzingwane RDC	10	255	1	39	139	11	0	455	444
13**Vungu RDC	6	607	0	9	85	10	0	717	707
13**Wedza RDC	6	554	2	26	327	10	0	925	915
13**Zaka RDC	13	1045	6	41	297	29	0	1431	1402
13**Zibagwe RDC	17	854	8	52	570	18	0	1519	1501
13**Zvataida RDC	8	2653	2	11	134	148	0	2956	2808
13**Zvimba RDC	21	3427	2	13	111	35	0	3609	3574
14**Beitbridge RDC	18	766	8	23	222	31	0	1068	1037
14**Bikita RDC	14	707	8	88	639	44	0	1500	1456
14**Bindura RDC	5	1153	3	20	389	13	0	1583	1570
14**Binga RDC	94	1007	51	354	2194	113	0	3813	3700
14**Bubi RDC	8	355	0	24	51	19	0	457	438
14**Buhera RDC	11	1630	4	74	1184	75	0	2978	2903
14**Bulawayo City Council	31	770	5	279	2948	43	0	4076	4033
14**Bulilima RDC	14	355	14	78	543	29	0	1033	1004
14**Chaminuka RDC	8	3008	4	2	53	52	0	3127	3075
14**Chegutu RDC	2	1022	3	14	190	22	0	1253	1231
14**Chikomba RDC	1	325	0	17	253	5	0	601	596
14**Chimanimani RDC	6	801	1	19	315	28	0	1170	1142
14**Chinhoyi Municipality	3	661	0	18	598	14	0	1294	1280
14**Chipinge RDC	19	384	9	124	618	56	0	1210	1154
14**Chiredzi RDC	36	823	15	31	97	50	0	1052	1002
14**Chitungwiza Municipality	15	1673	1	49	2154	39	0	3931	3892
14**Chivi RDC	42	1221	9	39	314	51	0	1676	1625
14**Gokwe North RDC	20	1651	3	59	464	54	0	2251	2197
14**Gokwe South RDC	24	2027	9	78	490	62	0	2690	2628
14**Goromonzi RDC	7	1378	3	33	1075	27	0	2523	2496
14**Guruve RDC	7	1309	2	6	165	39	0	1528	1489
14**Gutu RDC	18	507	6	27	204	17	0	779	762
14**Gwanda Rural	18	551	11	231	571	16	0	1398	1382
14**Gweru Municipality	4	554	2	42	985	13	0	1600	1587
14**Harare Municipality	14	3103	9	155	6766	117	1	10164	10047
14**Hurungwe RDC	75	3260	33	118	736	117	1	4339	4222
14**Hwange Local Board	3	195	0	24	883	17	0	1122	1105
14**Hwange RDC	6	211	13	98	697	27	0	1052	1025
14**Insiza RDC	18	406	6	12	69	9	0	520	511
14**Kadoma City Council	2	875	1	12	724	16	0	1630	1614
14**Kusile RDC	10	259	16	75	492	19	0	871	852
14**Kwekwe Municipality	1	364	0	18	684	14	0	1081	1067
14**Makonde RDC	21	1044	7	32	235	23	0	1362	1339
14**Makoni RDC	26	1102	5	54	300	23	0	1510	1487
14**Mangwe RDC	6	268	1	28	367	16	0	686	670
14**Manyame RDC	3	559	2	14	105	11	0	694	683
14**Marondera RDC	15	1062	5	78	601	44	0	1805	1761
14**Masvingo RDC	40	980	17	78	430	38	0	1583	1545
14**Matobo RDC	27	467	4	68	520	18	0	1104	1086
14**Mazowe RDC	11	1865	8	18	198	37	0	2137	2100
14**Mberengwa RDC	13	911	6	21	107	35	0	1093	1058
14**Mbire RDC	15	1225	6	18	120	33	0	1417	1384
14**Mhondoro-Ngezi RDC	15	3370	2	16	308	101	0	3812	3711
14**Mudzi RDC	18	3908	10	16	132	69	1	4153	4084
14**Murewa RDC	16	1543	5	33	445	44	0	2086	2042
14**Mutare Municipality	2	1052	2	50	2114	44	0	3264	3220
14**Mutare RDC	16	667	4	30	489	13	0	1219	1206
14**Mutasa RDC	7	304	3	45	523	21	0	903	882
14**Mutoko RDC	3	1548	3	21	135	40	0	1750	1710
14**Muzarabani RDC	24	2270	3	4	57	43	0	2401	2358
14**Mwenezi RDC	23	2990	5	11	99	106	0	3234	3128
14**Nkayi RDC	25	415	11	107	554	50	0	1162	1112
14**Nyanga RDC	11	467	5	47	488	28	0	1046	1018
14**Pfura RDC	20	2960	3	17	235	69	0	3304	3235
14**Runde RDC	13	1557	4	12	170	24	0	1780	1756
14**Rushinga RDC	6	975	2	6	70	5	0	1064	1059
14**Sanyati RDC	2	287	1	6	113	6	0	415	409
14**Takawira RDC	0	400	1	10	309	15	0	735	720
14**Tongogara RDC	5	602	5	32	437	46	0	1127	1081
14**Tsholotsho RDC	24	383	12	78	263	58	0	818	760
14**Umguza RDC	15	1061	5	40	248	37	0	1406	1369
14**Umzingwane RDC	28	765	7	23	100	33	0	956	923
14**Vungu RDC	10	2059	2	23	693	38	0	2825	2787
14**Wedza RDC	4	492	4	14	162	5	0	681	676
14**Zaka RDC	18	925	5	29	401	42	0	1420	1378
14**Zibagwe RDC	41	780	9	125	558	43	0	1556	1513
14**Zvataida RDC	7	2563	3	29	272	39	0	2913	2874
14**Zvimba RDC	5	1807	5	3	114	24	0	1958	1934
15**Beitbridge RDC	12	639	5	30	144	38	0	868	830
15**Bikita RDC	16	1145	17	113	696	54	0	2041	1987
15**Bindura RDC	8	1017	4	41	486	18	0	1574	1556
15**Binga RDC	10	344	14	87	1091	101	0	1647	1546
15**Bubi RDC	8	212	3	40	264	35	0	562	527
15**Buhera RDC	34	1804	7	90	760	70	0	2765	2695
15**Bulawayo City Council	56	618	4	293	2303	21	0	3295	3274
15**Bulilima RDC	2	245	3	35	207	16	0	508	492
15**Chaminuka RDC	5	2089	1	0	22	20	0	2137	2117
15**Chegutu RDC	15	1012	4	16	336	25	0	1408	1383
15**Chikomba RDC	11	1240	6	46	370	44	0	1717	1673
15**Chimanimani RDC	5	720	4	41	778	26	0	1574	1548
15**Chinhoyi Municipality	0	546	1	9	261	14	0	831	817
15**Chipinge RDC	15	590	18	140	1010	68	0	1841	1773
15**Chiredzi RDC	49	1085	29	153	515	67	0	1898	1831
15**Chitungwiza Municipality	2	1339	5	47	1562	39	0	2994	2955
15**Chivi RDC	40	1029	7	41	296	25	0	1438	1413
15**Gokwe North RDC	22	1493	5	56	524	47	0	2147	2100
15**Gokwe South RDC	28	2242	13	113	980	60	0	3436	3376
15**Goromonzi RDC	1	622	1	17	638	9	0	1288	1279
15**Guruve RDC	4	959	0	2	11	11	0	987	976
15**Gutu RDC	30	1507	16	177	1010	88	0	2828	2740
15**Gwanda RDC	12	763	6	77	348	13	0	1219	1206
15**Gweru Municipality	5	1122	3	39	1946	35	0	3150	3115
15**Harare Municipality	25	3217	12	222	8877	76	1	12429	12353
15**Hurungwe RDC	6	828	6	49	400	37	0	1326	1289
15**Hwange Local Board	3	163	1	17	602	15	0	801	786
15**Hwange RDC	15	373	7	156	674	41	0	1266	1225
15**Insiza RDC	8	408	1	50	421	7	0	895	888
15**Kadoma City Council	2	521	0	13	918	20	0	1474	1454
15**Kusile RDC	13	603	11	111	843	33	0	1614	1581
15**Makonde RDC	24	974	8	27	276	15	0	1324	1309
15**Makoni RDC	19	1026	3	84	1041	43	0	2216	2173
15**Mangwe RDC	19	267	18	144	420	21	0	889	868
15**Manyame RDC	9	949	0	6	93	13	0	1070	1057
15**Marondera RDC	8	1162	8	47	450	42	0	1717	1675
15**Masvingo RDC	11	864	5	52	417	43	0	1392	1349
15**Matobo RDC	7	116	6	95	774	55	0	1053	998
15**Mazowe RDC	7	877	1	26	568	14	0	1493	1479
15**Mberengwa RDC	10	901	4	24	250	25	0	1214	1189
15**Mbire RDC	24	1333	5	32	339	26	0	1759	1733
15**Mhondoro-Ngezi RDC	9	1622	6	17	160	29	0	1843	1814
15**Mudzi RDC	23	2837	9	19	275	90	0	3253	3163
15**Murewa RDC	10	1201	7	43	343	41	1	1645	1604
15**Mutare Municipality	13	1558	2	34	1543	30	0	3180	3150
15**Mutare RDC	25	1287	22	139	1577	64	0	3114	3050
15**Mutasa RDC	4	408	1	30	613	24	0	1080	1056
15**Mutoko RDC	4	1558	4	11	156	42	0	1775	1733
15**Muzarabani RDC	5	1034	2	9	195	23	0	1268	1245
15**Mwenezi RDC	18	2407	7	11	123	81	0	2647	2566
15**Nkayi RDC	17	269	4	24	290	17	0	621	604
15**Nyanga RDC	20	815	21	108	971	69	0	2004	1935
15**Pfura RDC	18	2732	4	14	125	41	1	2934	2893
15**Runde RDC	9	1132	9	47	421	34	0	1652	1618
15**Rushinga RDC	5	1185	1	6	105	18	0	1320	1302
15**Sanyati RDC	0	282	0	3	74	6	0	365	359
15**Takawira RDC	8	1491	3	6	89	30	0	1627	1597
15**Tongogara RDC	4	529	1	16	429	11	0	990	979
15**Tsholotsho RDC	76	508	28	179	633	33	0	1457	1424
15**Umguza RDC	5	473	6	16	175	11	0	686	675
15**Umzingwane RDC	0	98	3	13	134	4	0	252	248
15**Vungu RDC	3	771	3	50	275	14	0	1116	1102
15**Wedza RDC	1	709	0	14	346	17	0	1087	1070
15**Zaka RDC	20	1762	5	62	616	73	0	2538	2465
15**Zibagwe RDC	9	1123	4	23	232	28	0	1419	1391
15**Zvataida RDC	20	2156	7	29	248	111	0	2571	2460
15**Zvimba RDC	17	2314	4	35	898	40	0	3308	3268
16**Bikita RDC	11	888	9	102	581	69	0	1660	1591
16**Bindura RDC	9	1482	2	43	566	38	0	2140	2102
16**Binga RDC	18	204	13	95	914	29	0	1273	1244
16**Bubi RDC	3	115	6	22	270	17	9	433	416
16**Buhera RDC	15	1236	2	56	823	46	0	2178	2132
16**Bulawayo City Council	71	703	1	365	2620	22	0	3782	3760
16**Bulilima RDC	2	192	5	38	205	20	0	462	442
16**Chaminuka RDC	7	1890	0	5	113	33	0	2048	2015
16**Chegutu RDC	0	386	1	5	101	5	0	498	493
16**Chikomba RDC	10	1116	2	61	598	17	0	1804	1787
16**Chimanimani RDC	46	1893	5	103	634	59	0	2740	2681
16**Chipinge RDC	24	1197	8	125	1764	103	0	3221	3118
16**Chiredzi RDC	63	6349	16	13	174	87	0	6702	6615
16**Chitungwiza Municipality	4	1133	2	64	2429	29	0	3661	3632
16**Chivi RDC	24	1178	12	68	630	76	0	1988	1912
16**Gokwe North RDC	12	1165	4	214	472	30	0	1897	1867
16**Gokwe South RDC	19	1763	8	120	855	165	0	2930	2765
16**Goromonzi RDC	11	2355	9	58	1375	53	0	3861	3808
16**Guruve RDC	8	1451	4	18	83	14	0	1578	1564
16**Gutu RDC	28	1257	11	101	460	57	0	1914	1857
16**Gwanda RDC	58	541	15	178	567	24	0	1383	1359
16**Gweru Municipality	6	627	0	12	883	16	0	1544	1528
16**Harare Municipality	18	1926	4	102	5057	67	1	7174	7107
16**Hurungwe RDC	9	1354	9	35	451	42	0	1900	1858
16**Hwange RDC	15	352	14	185	730	57	0	1353	1296
16**Insiza RDC	15	511	1	12	116	11	0	666	655
16**Kadoma City Council	4	1331	3	32	664	22	0	2056	2034
16**Kusile RDC	14	358	9	68	532	22	0	1003	981
16**Makonde RDC	23	1069	13	41	280	24	0	1450	1426
16**Makoni RDC	21	2175	12	117	1481	79	0	3885	3806
16**Mangwe RDC	32	302	34	228	367	36	0	999	963
16**Manyame RDC	3	332	3	11	99	2	0	450	448
16**Marondera RDC	10	970	3	29	314	17	1	1343	1326
16**Masvingo RDC	28	804	13	98	738	83	0	1764	1681
16**Matobo RDC	21	403	7	66	517	10	0	1024	1014
16**Mazowe RDC	9	704	5	40	327	30	0	1115	1085
16**Mberengwa RDC	6	889	1	23	223	44	0	1186	1142
16**Mbire RDC	15	1103	2	13	83	33	0	1249	1216
16**Mhondoro-Ngezi RDC	10	1272	2	9	120	26	0	1439	1413
16**Mudzi RDC	12	2182	15	15	172	67	0	2463	2396
16**Murewa RDC	7	1824	15	43	432	37	0	2358	2321
16**Mutare Municipality	8	1506	1	57	3384	45	2	5001	4956
16**Mutare RDC	49	2574	12	83	634	90	0	3442	3352
16**Mutasa RDC	5	310	0	28	413	29	0	785	756
16**Mutoko RDC	13	1858	6	38	464	33	0	2412	2379
16**Muzarabani RDC	2	697	1	3	11	8	0	722	714
16**Mwenezi RDC	28	4675	10	32	292	91	0	5128	5037
16**Nkayi RDC	20	151	13	71	527	22	0	804	782
16**Nyanga RDC	7	551	3	17	135	12	0	725	713
16**Pfura RDC	11	2035	4	9	189	40	0	2288	2248
16**Runde RDC	8	814	0	13	204	32	0	1071	1039
16**Rushinga RDC	4	1538	0	0	30	8	1	1580	1572
16**Sanyati RDC	29	1763	7	11	194	64	0	2068	2004
16**Takawira RDC	1	1144	1	3	63	80	0	1292	1212
16**Tongogara RDC	2	915	2	9	124	32	0	1084	1052
16**Tsholotsho RDC	12	407	6	59	319	49	0	852	803
16**Umguza RDC	33	1150	2	70	997	49	0	2301	2252
16**Umzingwane RDC	4	388	1	24	291	9	0	717	708
16**Vungu RDC	18	1780	4	19	269	40	0	2130	2090
16**Zaka RDC	16	815	13	42	287	42	0	1215	1173
16**Zibagwe RDC	21	582	8	63	520	32	0	1226	1194
16**Zvataida RDC	23	2924	3	10	55	66	0	3081	3015
16**Zvimba RDC	3	564	1	7	194	4	0	773	769
17**Bikita RDC	5	636	13	96	872	51	0	1673	1622
17**Bindura RDC	15	1018	2	64	555	37	0	1691	1654
17**Binga RDC	52	907	37	331	1692	126	0	3145	3019
17**Bubi RDC	6	235	1	39	225	17	0	523	506
17**Buhera RDC	7	876	3	48	418	24	0	1376	1352
17**Bulawayo City Council	58	854	10	242	2153	48	0	3365	3317
17**Bulilima RDC	0	62	0	4	36	1	0	103	102
17**Chaminuka RDC	6	2621	0	3	30	54	0	2714	2660
17**Chegutu RDC	2	304	0	6	143	3	0	458	455
17**Chikomba RDC	21	1373	8	84	513	32	0	2031	1999
17**Chimanimani RDC	9	1036	6	53	664	55	0	1823	1768
17**Chipinge RDC	31	1356	12	179	1467	82	0	3127	3045
17**Chiredzi RDC	48	5454	12	31	147	108	0	5800	5692
17**Chitungwiza Municipality	7	970	4	39	2431	22	0	3473	3451
17**Chivi RDC	27	860	8	25	261	27	0	1208	1181
17**Gokwe North RDC	8	1415	3	23	141	25	0	1615	1590
17**Gokwe South RDC	14	578	14	58	934	41	0	1639	1598
17**Goromonzi RDC	8	1302	2	2	116	25	0	1455	1430
17**Guruve RDC	1	551	1	1	27	4	0	585	581
17**Gutu RDC	9	688	2	25	324	13	0	1061	1048
17**Gwanda RDC	39	619	9	138	413	9	0	1227	1218
17**Gweru Municipality	4	761	0	22	1088	14	0	1889	1875
17**Harare Municipality	13	2521	6	84	3625	65	0	6314	6249
17**Hurungwe RDC	31	1253	10	65	629	59	0	2047	1988
17**Hwange RDC	19	659	2	62	519	29	0	1290	1261
17**Insiza RDC	31	855	4	60	290	34	0	1274	1240
17**Kadoma City Council	2	435	0	14	558	28	0	1037	1009
17**Kusile RDC	13	489	6	122	283	23	0	936	913
17**Makonde RDC	15	1132	7	22	169	43	0	1388	1345
17**Makoni RDC	12	2032	5	18	294	50	0	2411	2361
17**Mangwe RDC	24	246	11	174	343	34	0	832	798
17**Manyame RDC	4	616	2	2	95	3	0	722	719
17**Marondera RDC	12	561	1	55	394	28	0	1051	1023
17**Masvingo RDC	11	1131	3	50	576	27	0	1798	1771
17**Matobo RDC	39	226	9	141	407	15	0	837	822
17**Mazowe RDC	6	914	2	22	712	16	0	1672	1656
17**Mberengwa RDC	15	948	3	38	278	24	0	1306	1282
17**Mbire RDC	16	847	5	30	258	47	0	1203	1156
17**Mudzi RDC	11	1672	4	24	240	35	0	1986	1951
17**Murewa RDC	17	961	1	48	343	44	0	1414	1370
17**Mutare Municipality	15	1907	7	64	3713	59	0	5765	5706
17**Mutare RDC	13	1186	7	37	475	42	0	1760	1718
17**Mutasa RDC	10	542	1	76	1080	34	0	1743	1709
17**Mutoko RDC	9	1805	1	23	520	73	0	2431	2358
17**Muzarabani RDC	8	2182	0	4	45	14	0	2253	2239
17**Mwenezi RDC	43	4451	4	6	62	156	0	4722	4566
17**Nkayi RDC	18	381	5	52	438	18	0	912	894
17**Nyanga RDC	4	642	4	50	444	39	0	1183	1144
17**Pfura RDC	9	2149	2	10	110	7	0	2287	2280
17**Runde RDC	8	1338	3	41	380	38	0	1808	1770
17**Rushinga RDC	2	907	1	2	50	12	0	974	962
17**Sanyati RDC	17	1621	4	17	192	18	0	1869	1851
17**Takawira RDC	2	320	0	2	298	10	0	632	622
17**Tongogara RDC	2	948	0	12	160	30	0	1152	1122
17**Tsholotsho RDC	13	470	9	62	329	27	0	910	883
17**Umguza RDC	53	225	0	9	38	8	0	333	325
17**Umzingwane RDC	9	458	2	43	212	17	0	741	724
17**Vungu RDC	9	906	7	26	185	25	0	1158	1133
17**Zaka RDC	19	750	4	25	248	35	0	1081	1046
17**Zibagwe RDC	6	652	10	101	598	53	0	1420	1367
17**Zvataida RDC	12	1993	2	9	49	16	0	2081	2065
17**Zvimba RDC	12	2099	6	31	179	63	0	2390	2327
18**Bikita RDC	10	673	7	58	387	53	0	1188	1135
18**Bindura RDC	5	504	1	33	362	15	0	920	905
18**Binga RDC	17	315	4	77	854	69	0	1336	1267
18**Bubi RDC	7	195	9	43	408	23	0	685	662
18**Buhera RDC	14	1026	1	37	722	42	0	1842	1800
18**Bulawayo City Council	63	882	9	462	3026	30	0	4472	4442
18**Bulilima RDC	3	124	2	40	48	5	0	222	217
18**Chaminuka RDC	6	1561	1	2	40	28	0	1638	1610
18**Chegutu RDC	1	346	0	5	64	6	0	422	416
18**Chikomba RDC	11	559	1	35	374	24	0	1004	980
18**Chimanimani RDC	7	512	2	35	342	14	0	912	898
18**Chipinge RDC	17	866	11	135	937	66	0	2032	1966
18**Chiredzi RDC	9	1341	0	47	1490	23	0	2910	2887
18**Chitungwiza Municipality	4	1927	2	38	1859	47	0	3877	3830
18**Chivi RDC	8	1019	3	23	375	36	0	1464	1428
18**Gokwe North RDC	5	1500	5	40	146	21	0	1717	1696
18**Gokwe South RDC	18	1293	8	49	352	44	0	1764	1720
18**Goromonzi RDC	5	1542	9	33	563	34	0	2186	2152
18**Guruve RDC	13	1282	1	8	153	26	0	1483	1457
18**Gutu RDC	12	863	7	47	376	41	0	1346	1305
18**Gwanda RDC	79	835	15	87	334	22	0	1372	1350
18**Gweru Municipality	7	574	0	24	989	10	4	1604	1594
18**Harare Municipality	16	1526	3	88	2633	60	0	4326	4266
18**Hurungwe RDC	29	2763	3	5	86	40	0	2926	2886
18**Hwange RDC	9	370	1	27	457	23	0	887	864
18**Insiza RDC	11	376	4	63	375	45	0	874	829
18**Kusile RDC	5	320	5	105	503	14	0	952	938
18**Makonde RDC	21	1066	8	34	201	42	0	1372	1330
18**Makoni RDC	14	736	1	47	541	34	0	1373	1339
18**Manyame RDC	2	476	0	2	67	7	0	554	547
18**Marondera RDC	16	717	6	34	375	17	0	1165	1148
18**Masvingo RDC	12	1365	12	53	511	81	0	2034	1953
18**Matobo RDC	16	239	9	48	512	21	0	845	824
18**Mazowe RDC	8	1188	4	19	237	25	0	1481	1456
18**Mberengwa RDC	21	1864	7	41	365	36	0	2334	2298
18**Mudzi RDC	7	1380	1	10	82	38	0	1518	1480
18**Murewa RDC	10	854	5	35	315	24	0	1243	1219
18**Mutare Municipality	6	1090	2	15	1489	30	0	2632	2602
18**Mutare RDC	19	1587	3	55	658	48	0	2370	2322
18**Mutasa RDC	6	453	2	18	550	12	0	1041	1029
18**Mutoko RDC	8	2900	4	29	216	60	0	3217	3157
18**Muzarabani RDC	3	861	1	1	8	8	0	882	874
18**Mwenezi RDC	4	816	1	27	548	18	0	1414	1396
18**Nkayi RDC	4	209	7	82	424	28	0	754	726
18**Nyanga RDC	5	661	1	69	720	28	0	1484	1456
18**Pfura RDC	23	2987	2	0	45	20	0	3077	3057
18**Runde RDC	14	1033	2	30	344	37	0	1460	1423
18**Rushinga RDC	9	1612	5	6	38	22	0	1692	1670
18**Sanyati RDC	5	558	0	12	464	9	0	1048	1039
18**Takawira RDC	2	650	0	0	59	18	0	729	711
18**Tongogara RDC	16	2554	3	62	247	98	0	2980	2882
18**Tsholotsho RDC	13	562	5	81	166	18	0	845	827
18**Umguza RDC	10	270	8	41	193	27	0	549	522
18**Umzingwane RDC	31	214	3	50	969	20	0	1287	1267
18**Vungu RDC	6	1369	2	10	272	27	0	1686	1659
18**Zaka RDC	18	819	9	51	699	51	0	1647	1596
18**Zibagwe RDC	1	465	3	26	240	15	0	750	735
18**Zvimba RDC	7	1113	4	4	151	29	0	1308	1279
19**Bikita RDC	10	902	7	62	561	58	1	1600	1542
19**Bindura RDC	14	1652	1	7	175	18	0	1867	1849
19**Binga RDC	47	378	20	143	1091	97	0	1776	1679
19**Bubi RDC	12	218	2	40	302	28	0	602	574
19**Buhera RDC	20	1199	11	62	473	78	0	1843	1765
19**Bulawayo City Council	56	927	4	278	2524	51	0	3840	3789
19**Bulilima RDC	16	933	2	25	298	61	0	1335	1274
19**Chaminuka RDC	15	1873	0	4	45	17	0	1954	1937
19**Chegutu RDC	1	358	0	7	123	4	0	493	489
19**Chikomba RDC	10	722	2	26	286	23	0	1069	1046
19**Chimanimani RDC	6	635	1	31	429	23	0	1125	1102
19**Chipinge RDC	24	887	18	139	1166	57	0	2291	2234
19**Chiredzi RDC	23	1345	7	84	1427	36	0	2922	2886
19**Chitungwiza Municipality	4	1152	3	48	1962	28	0	3197	3169
19**Chivi RDC	32	1003	7	42	445	38	0	1567	1529
19**Gokwe North RDC	19	1153	9	45	407	34	0	1667	1633
19**Gokwe South RDC	35	2070	27	125	935	55	0	3247	3192
19**Goromonzi RDC	1	89	0	1	37	4	0	132	128
19**Guruve RDC	28	2264	10	8	44	33	0	2387	2354
19**Gutu RDC	9	921	3	53	459	35	0	1480	1445
19**Gwanda RDC	24	715	9	112	362	43	0	1265	1222
19**Harare Municipality	18	1320	7	127	2836	120	0	4428	4308
19**Hurungwe RDC	13	2002	3	8	63	28	0	2117	2089
19**Hwange RDC	10	389	2	41	384	27	0	853	826
19**Insiza RDC	26	825	8	115	526	35	0	1535	1500
19**Kusile RDC	16	424	9	139	602	34	0	1224	1190
19**Makonde RDC	12	1776	3	14	130	22	0	1957	1935
19**Makoni RDC	11	627	7	39	554	29	0	1267	1238
19**Manyame RDC	6	457	0	3	58	4	0	528	524
19**Marondera RDC	5	748	5	21	295	15	1	1089	1074
19**Masvingo RDC	8	674	3	29	403	39	0	1156	1117
19**Matobo RDC	66	429	8	112	600	35	0	1250	1215
19**Mazowe RDC	22	1317	7	37	507	33	0	1923	1890
19**Mberengwa RDC	12	1471	8	25	225	31	0	1772	1741
19**Murewa RDC	8	875	0	19	132	27	0	1061	1034
19**Mutare Municipality	6	247	0	6	380	10	0	649	639
19**Mutare RDC	9	1217	6	60	400	35	0	1727	1692
19**Mutasa RDC	13	958	14	75	783	39	0	1882	1843
19**Mutoko RDC	10	2500	6	12	131	41	0	2700	2659
19**Muzarabani RDC	5	1181	3	11	33	17	0	1250	1233
19**Nkayi RDC	13	252	6	93	562	20	0	946	926
19**Nyanga RDC	11	608	6	40	606	28	0	1299	1271
19**Pfura RDC	13	3898	2	1	28	51	0	3993	3942
19**Runde RDC	3	1013	3	16	196	92	0	1323	1231
19**Rushinga RDC	4	1172	2	4	38	6	0	1226	1220
19**Takawira RDC	4	1661	3	3	76	32	0	1779	1747
19**Tongogara RDC	6	1084	6	10	249	44	0	1399	1355
19**Tsholotsho RDC	26	517	13	85	376	26	0	1043	1017
19**Umguza RDC	25	1308	6	37	142	65	0	1583	1518
19**Umzingwane RDC	20	768	6	39	230	24	0	1087	1063
19**Vungu RDC	9	955	8	144	177	21	0	1314	1293
19**Zaka RDC	15	1347	6	81	1242	62	0	2753	2691
19**Zibagwe RDC	2	558	7	27	224	32	0	850	818
19**Zvimba RDC	16	1751	2	22	201	33	0	2025	1992
2**Beitbridge RDC	16	939	5	16	57	16	0	1049	1033
2**Beitbridge Town Council	1	257	0	10	409	6	0	683	677
2**Bikita RDC	19	1594	9	95	653	59	0	2429	2370
2**Bindura Municipality	2	553	3	7	312	9	0	886	877
2**Bindura RDC	9	2352	2	0	12	14	0	2389	2375
2**Binga RDC	20	490	17	104	798	108	0	1537	1429
2**Bubi RDC	12	210	3	71	382	54	0	732	678
2**Buhera RDC	11	640	4	35	695	24	0	1409	1385
2**Bulawayo City Council	61	1237	10	312	3172	62	3	4854	4792
2**Bulilima RDC	12	279	10	82	304	20	0	707	687
2**Chaminuka RDC	3	652	0	3	21	12	0	691	679
2**Chegutu Municipality	0	184	2	6	341	3	0	536	533
2**Chegutu RDC	8	1801	4	66	951	43	0	2873	2830
2**Chikomba RDC	1	443	2	19	283	13	0	761	748
2**Chimanimani RDC	6	648	1	30	428	28	0	1141	1113
2**Chinhoyi Municipality	2	524	1	11	493	30	0	1061	1031
2**Chipinge RDC	22	548	15	113	899	38	0	1635	1597
2**Chipinge Town Council	5	388	0	9	444	7	0	853	846
2**Chiredzi RDC	8	1208	6	29	559	34	0	1844	1810
2**Chitungwiza Municipality	3	970	4	32	1350	38	0	2397	2359
2**Chivi RDC	11	985	11	44	759	39	0	1849	1810
2**Epworth Local Board	6	3316	4	70	1560	67	0	5023	4956
2**Gokwe North RDC	41	1389	30	145	1167	113	0	2885	2772
2**Gokwe South RDC	5	895	2	49	507	17	0	1475	1458
2**Gokwe Town Council	1	439	2	13	476	5	0	936	931
2**Goromonzi RDC	22	1982	5	67	1129	41	0	3246	3205
2**Guruve RDC	8	1774	4	0	12	19	0	1817	1798
2**Gutu RDC	10	733	5	33	265	22	0	1068	1046
2**Gwanda Municipality	1	132	1	33	235	0	0	402	402
2**Gwanda R.D.C	8	354	7	90	515	24	0	998	974
2**Gweru Municipality	11	1683	3	39	1772	35	0	3543	3508
2**Harare Municipality	23	3903	2	114	4620	89	0	8751	8662
2**Hurungwe RDC	14	2018	1	8	116	17	0	2174	2157
2**Hwange Local Board	0	51	0	2	160	1	0	214	213
2**Hwange RDC	13	536	3	53	737	29	0	1371	1342
2**Insiza RDC	12	815	7	86	272	30	0	1222	1192
2**Kadoma City Council	7	817	6	23	1012	41	0	1906	1865
2**Kariba Municipality	0	924	4	27	1208	37	0	2200	2163
2**Karoi Town Council	0	165	0	8	195	10	0	378	368
2**Kusile RDC	5	220	3	27	152	5	0	412	407
2**Kwekwe Municipality	5	1121	1	47	1489	39	0	2702	2663
2**Makonde RDC	26	2524	3	15	128	45	0	2741	2696
2**Makoni RDC	10	1298	6	23	326	34	0	1697	1663
2**Mangwe RDC	7	424	8	95	231	36	0	801	765
2**Manyame RDC	20	1041	3	51	860	43	0	2018	1975
2**Marondera Municipality	2	515	1	22	661	11	0	1212	1201
2**Marondera RDC	7	644	1	7	214	6	0	879	873
2**Masvingo Municipality	4	878	0	28	952	23	0	1885	1862
2**Masvingo RDC	8	830	6	72	628	29	0	1573	1544
2**Matobo RDC	26	850	8	66	426	22	0	1398	1376
2**Mazowe RDC	17	1406	0	10	131	26	0	1590	1564
2**Mberengwa RDC	25	3108	9	23	348	87	0	3600	3513
2**Mbire RDC	20	1446	5	25	214	38	0	1748	1710
2**Mhondoro-Ngezi RDC	5	709	0	9	116	15	0	854	839
2**Mudzi RDC	29	2500	10	49	295	53	0	2936	2883
2**Murewa RDC	5	1004	2	19	167	18	0	1215	1197
2**Mutare Municipality	4	715	2	35	1731	18	0	2505	2487
2**Mutare RDC	22	1654	9	30	260	53	0	2028	1975
2**Mutasa RDC	6	463	1	18	326	24	0	838	814
2**Mutoko RDC	14	2271	2	15	97	30	0	2429	2399
2**Muzarabani RDC	3	1715	1	5	51	10	0	1785	1775
2**Mwenezi RDC	22	1127	7	37	325	31	0	1549	1518
2**Nkayi RDC	12	483	5	46	281	29	0	856	827
2**Norton Town Council	0	208	0	3	169	5	0	385	380
2**Nyaminyami RDC	0	433	0	4	77	3	0	517	514
2**Nyanga RDC	16	1308	3	44	402	68	0	1841	1773
2**Pfura RDC	12	4032	7	17	214	58	0	4340	4282
2**Plumtree Town Council	9	91	0	13	213	3	0	329	326
2**Redcliff Municipality	0	293	0	23	789	8	0	1113	1105
2**Runde RDC	9	797	4	20	207	9	0	1046	1037
2**Rusape Town Council	3	249	0	7	267	7	0	533	526
2**Rushinga RDC	0	734	0	1	28	14	0	777	763
2**Ruwa Local Board	1	720	2	7	1084	13	0	1827	1814
2**Sanyati RDC	23	4086	14	45	444	109	0	4721	4612
2**Shurugwi Town Council	1	123	0	3	169	3	0	299	296
2**Takawira RDC	15	620	8	33	498	22	0	1196	1174
2**Tongogara RDC	14	898	1	14	179	19	0	1125	1106
2**Tsholotsho RDC	15	336	8	77	512	15	0	963	948
2**Umguza RDC	31	4364	5	129	1129	123	0	5781	5658
2**Umzingwane RDC	16	392	6	55	446	18	0	933	915
2**Victoria Falls Municipality	4	433	0	15	277	7	0	736	729
2**Vungu RDC	7	290	22	153	599	13	0	1084	1071
2**Wedza RDC	13	2729	2	27	245	34	0	3050	3016
2**Zaka RDC	12	697	6	56	445	23	0	1239	1216
2**Zibagwe RDC	11	1580	1	10	143	27	0	1772	1745
2**Zvataida RDC	14	2731	1	10	106	30	0	2892	2862
2**Zvimba RDC	0	615	1	1	175	16	10	808	792
2**Zvishavane Town Council	2	533	3	17	520	13	0	1088	1075
20**Bikita RDC	26	1240	24	143	565	60	0	2058	1998
20**Bindura RDC	5	1166	1	5	118	28	0	1323	1295
20**Binga RDC	19	266	14	166	1118	77	0	1660	1583
20**Bubi RDC	18	1165	3	10	104	38	2	1338	1300
20**Buhera RDC	23	1239	6	62	510	88	0	1928	1840
20**Bulawayo City Council	68	965	2	231	2608	32	0	3906	3874
20**Bulilima RDC	8	295	3	41	205	10	0	562	552
20**Chaminuka RDC	6	2087	1	4	72	28	0	2198	2170
20**Chegutu RDC	6	1713	5	7	154	17	0	1902	1885
20**Chikomba RDC	18	955	7	77	461	27	0	1545	1518
20**Chimanimani RDC	11	808	6	122	1186	55	0	2188	2133
20**Chipinge RDC	13	1382	22	193	2182	127	0	3919	3792
20**Chiredzi RDC	12	4216	7	17	102	38	0	4392	4354
20**Chitungwiza Municipality	3	1172	6	53	1301	18	0	2553	2535
20**Chivi RDC	19	904	5	61	651	48	0	1688	1640
20**Gokwe North RDC	11	1192	2	18	113	20	0	1356	1336
20**Gokwe South RDC	21	1360	8	39	229	40	0	1697	1657
20**Goromonzi RDC	1	866	2	16	483	20	0	1388	1368
20**Guruve RDC	7	1621	7	35	309	26	0	2005	1979
20**Gutu RDC	3	285	1	12	224	8	0	533	525
20**Gwanda RDC	20	805	8	58	304	14	0	1209	1195
20**Harare Municipality	15	2316	7	174	3496	197	0	6205	6008
20**Hurungwe RDC	7	1307	2	14	90	20	0	1440	1420
20**Hwange RDC	9	170	11	55	992	50	0	1287	1237
20**Insiza RDC	27	2019	10	59	281	51	0	2447	2396
20**Kusile RDC	11	418	11	69	464	9	0	982	973
20**Makoni RDC	10	887	4	52	742	49	0	1744	1695
20**Manyame RDC	9	953	1	8	93	14	0	1078	1064
20**Marondera RDC	7	759	2	32	283	8	0	1091	1083
20**Masvingo RDC	10	929	3	50	369	34	0	1395	1361
20**Mazowe RDC	12	1482	2	49	814	47	0	2406	2359
20**Mberengwa RDC	10	713	3	27	209	22	0	984	962
20**Murewa RDC	19	1450	1	18	122	19	0	1629	1610
20**Mutare RDC	15	1016	7	39	637	42	0	1756	1714
20**Mutasa RDC	6	509	6	31	561	27	0	1140	1113
20**Mutoko RDC	16	3687	3	42	1345	63	0	5156	5093
20**Muzarabani RDC	8	847	2	11	61	10	0	939	929
20**Nkayi RDC	12	219	10	75	493	19	0	828	809
20**Nyanga RDC	6	394	3	33	361	22	0	819	797
20**Pfura RDC	3	2210	1	1	24	30	0	2269	2239
20**Rushinga RDC	3	586	1	0	2	3	0	595	592
20**Takawira RDC	10	2661	4	20	505	49	0	3249	3200
20**Tongogara RDC	6	833	1	10	199	9	0	1058	1049
20**Tsholotsho RDC	4	443	1	6	68	13	0	535	522
20**Umzingwane RDC	9	666	4	19	99	14	0	811	797
20**Zaka RDC	22	978	7	46	533	28	0	1614	1586
20**Zibagwe RDC	9	289	6	48	812	44	0	1208	1164
20**Zvimba RDC	8	1127	6	24	228	37	0	1430	1393
21**Bikita RDC	5	585	7	57	318	34	0	1006	972
21**Bindura RDC	11	1960	1	11	485	24	0	2492	2468
21**Binga RDC	85	1666	48	272	1235	148	0	3454	3306
21**Bubi RDC	24	1576	2	16	84	32	0	1734	1702
21**Buhera RDC	21	909	11	87	519	84	0	1631	1547
21**Bulawayo City Council	60	1184	4	265	4712	78	0	6303	6225
21**Bulilima RDC	7	239	3	47	232	15	0	543	528
21**Chaminuka RDC	1	1126	0	1	27	19	0	1174	1155
21**Chegutu RDC	5	1012	4	20	165	20	0	1226	1206
21**Chikomba RDC	8	470	1	156	345	27	0	1007	980
21**Chimanimani RDC	27	938	11	74	522	57	0	1629	1572
21**Chipinge RDC	20	1025	19	111	1027	63	0	2265	2202
21**Chiredzi RDC	18	1645	7	90	746	63	0	2569	2506
21**Chitungwiza Municipality	6	1537	0	67	2724	38	0	4372	4334
21**Chivi RDC	22	1165	2	34	232	30	0	1485	1455
21**Gokwe North RDC	7	1301	3	10	103	30	0	1454	1424
21**Gokwe South RDC	15	1687	6	64	548	71	0	2391	2320
21**Goromonzi RDC	1	788	1	7	128	11	0	936	925
21**Guruve RDC	11	2490	3	5	32	22	0	2563	2541
21**Gutu RDC	6	852	5	43	391	11	0	1308	1297
21**Gwanda Rural	4	730	1	58	976	16	0	1785	1769
21**Harare Municipality	18	1747	3	142	3274	115	0	5299	5184
21**Hurungwe RDC	14	2025	5	13	106	31	0	2194	2163
21**Insiza RDC	27	2011	7	34	95	29	0	2203	2174
21**Kusile RDC	36	495	16	118	462	31	0	1158	1127
21**Makoni RDC	19	458	3	40	403	15	0	938	923
21**Manyame RDC	1	360	1	2	33	3	0	400	397
21**Marondera RDC	12	1784	2	10	238	21	2	2067	2046
21**Masvingo RDC	4	640	1	19	357	10	0	1031	1021
21**Matobo RDC	7	209	2	1	17	4	0	240	236
21**Mazowe RDC	8	1349	6	16	292	21	0	1692	1671
21**Mberengwa RDC	12	1047	3	19	145	26	0	1252	1226
21**Murewa RDC	5	1204	5	41	264	29	0	1548	1519
21**Mutare RDC	13	927	4	32	359	38	0	1373	1335
21**Mutasa RDC	1	1000	1	26	1450	23	0	2501	2478
21**Mutoko RDC	3	291	1	4	50	3	0	352	349
21**Muzarabani RDC	6	861	0	1	21	11	0	900	889
21**Nkayi RDC	14	275	9	104	625	17	0	1044	1027
21**Nyanga RDC	17	874	15	46	420	70	0	1442	1372
21**Pfura RDC	0	324	0	2	31	1	0	358	357
21**Rushinga RDC	8	1039	1	1	21	7	0	1077	1070
21**Takawira RDC	3	602	1	20	315	21	0	962	941
21**Tongogara RDC	14	1404	3	29	249	40	0	1739	1699
21**Tsholotsho RDC	6	188	3	35	228	12	0	472	460
21**Zaka RDC	23	1119	7	51	396	43	0	1639	1596
21**Zibagwe RDC	23	1170	12	155	1342	106	0	2808	2702
21**Zvimba RDC	15	3227	8	35	618	58	0	3961	3903
22**Bikita RDC	8	1519	11	31	451	46	0	2066	2020
22**Binga RDC	17	370	5	43	459	53	0	947	894
22**Bubi RDC	18	429	9	44	458	54	0	1012	958
22**Buhera RDC	36	2059	19	82	563	201	0	2960	2759
22**Bulawayo City Council	87	816	2	211	2891	38	0	4045	4007
22**Bulilima RDC	13	248	5	32	306	26	0	630	604
22**Chaminuka RDC	3	1030	2	26	334	46	0	1441	1395
22**Chegutu RDC	8	2157	1	14	156	25	0	2361	2336
22**Chikomba RDC	10	622	1	37	336	15	0	1021	1006
22**Chimanimani RDC	20	914	12	93	638	120	0	1797	1677
22**Chipinge RDC	28	1062	22	149	1085	130	0	2476	2346
22**Chiredzi RDC	11	1128	4	13	109	35	0	1300	1265
22**Chitungwiza Municipality	7	1494	0	36	2159	48	0	3744	3696
22**Chivi RDC	12	1054	4	41	388	42	0	1541	1499
22**Gokwe North RDC	4	1363	5	13	173	21	0	1579	1558
22**Gokwe South RDC	19	1149	3	48	387	29	0	1635	1606
22**Goromonzi RDC	5	1469	1	7	243	25	0	1750	1725
22**Guruve RDC	26	1490	6	68	324	49	0	1963	1914
22**Gutu RDC	8	641	9	34	294	14	0	1000	986
22**Gwanda Rural	26	1109	0	68	600	19	0	1822	1803
22**Harare Municipality	7	2262	4	84	4668	66	0	7091	7025
22**Hurungwe RDC	21	2211	5	26	259	49	0	2571	2522
22**Insiza RDC	25	984	10	239	432	43	0	1733	1690
22**Kusile RDC	13	311	8	202	269	13	0	816	803
22**Makoni RDC	9	354	5	33	633	23	0	1057	1034
22**Marondera RDC	4	1364	2	11	109	16	0	1506	1490
22**Masvingo RDC	23	1601	7	35	274	62	0	2002	1940
22**Matobo RDC	2	230	1	10	116	5	0	364	359
22**Mazowe RDC	10	881	7	30	972	32	0	1932	1900
22**Mberengwa RDC	6	995	6	21	132	24	0	1184	1160
22**Murewa RDC	13	4927	5	6	79	40	0	5070	5030
22**Mutare RDC	24	1766	8	28	255	41	0	2122	2081
22**Mutasa RDC	3	417	0	12	395	10	0	837	827
22**Mutoko RDC	7	461	0	3	98	9	0	578	569
22**Muzarabani RDC	7	694	1	3	66	17	0	788	771
22**Nkayi RDC	27	354	14	151	703	42	0	1291	1249
22**Nyanga RDC	3	566	5	26	407	17	0	1024	1007
22**Pfura RDC	12	4178	2	1	39	33	0	4265	4232
22**Rushinga RDC	6	1633	2	1	22	14	0	1678	1664
22**Takawira RDC	4	512	1	7	138	9	0	671	662
22**Tongogara RDC	2	146	2	2	65	0	0	217	217
22**Tsholotsho RDC	25	563	6	150	698	23	0	1465	1442
22**Zaka RDC	6	475	1	60	460	38	0	1040	1002
22**Zibagwe RDC	17	868	10	54	774	63	0	1786	1723
22**Zvimba RDC	4	700	6	21	633	14	0	1378	1364
23**Bikita RDC	1	119	0	1	37	3	0	161	158
23**Binga RDC	15	401	24	165	927	101	0	1633	1532
23**Bubi RDC	13	659	2	16	66	25	0	781	756
23**Buhera RDC	22	1229	16	77	938	109	0	2391	2282
23**Bulawayo City Council	129	726	5	251	2397	31	0	3539	3508
23**Chaminuka RDC	3	420	1	4	137	9	0	574	565
23**Chegutu RDC	5	1365	1	13	101	19	0	1504	1485
23**Chikomba RDC	13	1076	5	64	602	40	0	1800	1760
23**Chimanimani RDC	26	718	5	76	652	67	0	1544	1477
23**Chipinge RDC	23	535	14	121	721	48	0	1462	1414
23**Chiredzi RDC	8	922	1	13	52	15	0	1011	996
23**Chitungwiza Municipality	9	2404	6	65	3304	61	4	5849	5788
23**Chivi RDC	28	1030	8	23	226	36	0	1351	1315
23**Gokwe North RDC	8	1623	3	12	185	19	0	1850	1831
23**Gokwe South RDC	36	2400	188	112	891	67	0	3694	3627
23**Goromonzi RDC	5	1436	4	21	374	45	0	1885	1840
23**Guruve RDC	18	1482	1	14	50	30	0	1595	1565
23**Gutu RDC	32	1276	11	87	617	97	0	2120	2023
23**Gwanda Rural	17	1437	5	19	156	24	0	1658	1634
23**Harare Municipality	19	1917	7	105	4943	99	0	7090	6991
23**Hurungwe RDC	23	1012	13	62	472	85	0	1667	1582
23**Insiza RDC	23	537	7	58	566	26	0	1217	1191
23**Kusile RDC	5	516	8	26	177	11	0	743	732
23**Makoni RDC	15	823	12	70	949	27	0	1896	1869
23**Marondera RDC	6	1891	7	14	340	23	0	2281	2258
23**Masvingo RDC	10	918	6	33	447	24	0	1438	1414
23**Matobo RDC	1	207	0	3	4	4	0	219	215
23**Mazowe RDC	7	1060	3	2	97	27	0	1196	1169
23**Mberengwa RDC	8	907	2	27	266	23	0	1233	1210
23**Murewa RDC	8	2543	5	16	189	33	0	2794	2761
23**Mutare RDC	17	1409	15	59	418	60	0	1978	1918
23**Mutasa RDC	8	1325	4	24	500	27	0	1888	1861
23**Mutoko RDC	1	370	1	0	39	3	0	414	411
23**Muzarabani RDC	10	1522	5	3	61	17	3	1618	1601
23**Nkayi RDC	8	194	3	61	406	38	0	710	672
23**Nyanga RDC	12	1108	5	34	359	42	0	1560	1518
23**Pfura RDC	6	1935	3	18	216	45	0	2223	2178
23**Rushinga RDC	2	882	1	0	9	18	0	912	894
23**Takawira RDC	6	596	4	32	348	15	0	1001	986
23**Tongogara RDC	9	417	0	8	112	12	0	558	546
23**Zaka RDC	22	829	4	45	300	57	0	1257	1200
23**Zibagwe RDC	3	147	4	5	99	3	0	261	258
23**Zvimba RDC	2	536	1	13	446	25	0	1023	998
24**Bikita RDC	8	871	7	57	299	43	0	1285	1242
24**Binga RDC	12	453	5	48	796	39	0	1353	1314
24**Buhera RDC	41	1536	10	91	1029	77	0	2784	2707
24**Bulawayo City Council	99	1326	7	264	3310	57	0	5063	5006
24**Chaminuka RDC	2	785	0	11	180	37	0	1015	978
24**Chegutu RDC	17	2102	6	24	353	52	0	2554	2502
24**Chikomba RDC	7	726	5	38	470	29	1	1275	1246
24**Chipinge RDC	44	1872	31	186	1487	134	0	3754	3620
24**Chiredzi RDC	50	4740	20	30	253	79	0	5172	5093
24**Chitungwiza Municipality	12	1804	2	65	2236	32	0	4151	4119
24**Chivi RDC	14	936	10	30	336	21	0	1347	1326
24**Gokwe North RDC	2	506	2	9	252	9	0	780	771
24**Gokwe South RDC	45	2538	21	145	1074	130	0	3953	3823
24**Goromonzi RDC	1	549	0	8	344	20	0	922	902
24**Guruve RDC	14	1219	5	24	156	28	0	1446	1418
24**Gutu RDC	14	877	3	42	580	48	0	1564	1516
24**Gwanda RDC	7	595	9	47	220	16	0	894	878
24**Harare Municipality	18	1807	4	121	4063	94	0	6107	6013
24**Hurungwe RDC	27	1597	8	97	646	38	0	2413	2375
24**Kusile RDC	7	460	2	5	60	13	0	547	534
24**Makoni RDC	9	1174	8	36	521	34	0	1782	1748
24**Masvingo RDC	20	1073	13	48	347	41	0	1542	1501
24**Matobo RDC	4	537	2	10	43	11	0	607	596
24**Mazowe RDC	13	1548	3	9	219	28	0	1820	1792
24**Mberengwa RDC	10	1116	2	13	122	21	0	1284	1263
24**Murewa RDC	11	3665	3	13	125	46	0	3863	3817
24**Mutare RDC	14	1224	4	57	613	28	0	1940	1912
24**Mutasa RDC	21	1152	12	85	1070	67	0	2407	2340
24**Mutoko RDC	2	355	1	3	45	0	0	406	406
24**Muzarabani RDC	8	1918	3	5	60	12	0	2006	1994
24**Nkayi RDC	28	180	9	116	607	47	0	987	940
24**Nyanga RDC	4	565	1	8	150	13	0	741	728
24**Pfura RDC	10	3303	7	17	197	53	0	3587	3534
24**Rushinga RDC	3	829	1	12	270	14	0	1129	1115
24**Takawira RDC	2	344	0	8	303	8	7	665	657
24**Tongogara RDC	6	558	2	9	377	13	0	965	952
24**Zaka RDC	24	989	14	119	664	32	0	1842	1810
24**Zibagwe RDC	17	818	11	56	621	31	0	1554	1523
24**Zvimba RDC	5	614	4	25	885	21	0	1554	1533
25**Bikita RDC	12	1003	8	26	198	36	0	1283	1247
25**Binga RDC	12	217	6	39	941	38	0	1253	1215
25**Buhera RDC	34	1488	16	91	740	70	0	2439	2369
25**Bulawayo City Council	72	1569	5	309	3237	41	0	5233	5192
25**Chaminuka RDC	3	756	0	5	79	13	0	856	843
25**Chegutu RDC	7	1316	4	9	99	21	0	1456	1435
25**Chikomba RDC	27	1210	4	68	762	46	0	2117	2071
25**Chipinge RDC	24	684	24	188	1318	106	0	2344	2238
25**Chiredzi RDC	4	565	4	12	133	37	0	755	718
25**Chitungwiza Municipality	3	2673	3	28	1958	45	0	4710	4665
25**Chivi RDC	30	1275	10	85	773	55	0	2228	2173
25**Gokwe North RDC	5	739	5	10	240	17	0	1016	999
25**Gokwe South RDC	21	2148	18	110	670	67	0	3034	2967
25**Goromonzi RDC	18	4644	9	104	2619	76	0	7470	7394
25**Gutu RDC	12	820	4	45	427	38	0	1346	1308
25**Harare Municipality	8	1954	2	158	4953	76	0	7151	7075
25**Hurungwe RDC	19	1690	10	73	692	81	0	2565	2484
25**Kusile RDC	11	185	1	5	30	5	0	237	232
25**Makoni RDC	7	1241	9	84	748	52	0	2141	2089
25**Masvingo RDC	19	675	12	41	327	39	0	1113	1074
25**Matobo RDC	21	567	3	47	426	24	0	1088	1064
25**Mazowe RDC	15	2058	1	5	73	38	0	2190	2152
25**Mberengwa RDC	8	1044	5	9	82	32	0	1180	1148
25**Murewa RDC	16	1557	1	23	313	42	0	1952	1910
25**Mutare RDC	28	1098	7	58	372	32	0	1595	1563
25**Mutasa RDC	5	794	2	16	321	27	0	1165	1138
25**Mutoko RDC	14	3642	2	8	152	48	0	3866	3818
25**Muzarabani RDC	11	934	0	0	13	22	0	980	958
25**Nkayi RDC	17	198	8	44	603	25	0	895	870
25**Nyanga RDC	6	460	1	19	271	8	0	765	757
25**Pfura RDC	1	420	0	18	129	9	0	577	568
25**Rushinga RDC	4	1006	0	6	70	19	0	1105	1086
25**Takawira RDC	4	854	1	41	492	30	0	1422	1392
25**Zaka RDC	15	1368	12	33	365	32	0	1825	1793
25**Zibagwe RDC	17	364	8	75	655	54	0	1173	1119
25**Zvimba RDC	10	1425	3	25	511	17	0	1991	1974
26**Bikita RDC	17	840	6	21	217	42	0	1143	1101
26**Buhera RDC	15	2228	11	42	373	37	0	2706	2669
26**Bulawayo City Council	72	949	4	262	2446	29	0	3762	3733
26**Chaminuka RDC	3	906	6	16	266	18	0	1215	1197
26**Chegutu RDC	7	1051	2	6	95	10	0	1171	1161
26**Chikomba RDC	18	1010	1	29	300	15	0	1373	1358
26**Chipinge RDC	34	2256	24	230	1702	181	0	4427	4246
26**Chiredzi RDC	6	1159	5	0	30	19	0	1219	1200
26**Chivi RDC	17	1720	15	46	254	65	0	2117	2052
26**Gokwe North RDC	5	608	2	9	240	15	0	879	864
26**Gokwe South RDC	24	1232	7	40	384	79	0	1766	1687
26**Gutu RDC	9	930	6	39	341	32	0	1357	1325
26**Harare Municipality	14	2056	6	157	5207	124	0	7564	7440
26**Hurungwe RDC	17	1734	18	83	483	69	0	2404	2335
26**Kusile RDC	2	85	1	30	120	5	0	243	238
26**Makoni RDC	28	1125	5	77	885	52	0	2172	2120
26**Masvingo RDC	17	1356	8	49	303	49	0	1782	1733
26**Mazowe RDC	21	1729	5	9	67	47	0	1878	1831
26**Mberengwa RDC	18	1154	0	21	254	22	0	1469	1447
26**Murewa RDC	20	1281	2	43	382	42	0	1770	1728
26**Mutare RDC	4	618	2	19	277	7	0	927	920
26**Mutasa RDC	3	683	2	20	645	18	0	1371	1353
26**Mutoko RDC	9	2092	4	19	215	25	1	2364	2339
26**Muzarabani RDC	6	1450	2	3	18	25	0	1504	1479
26**Nkayi RDC	18	251	5	56	277	23	0	630	607
26**Nyanga RDC	5	300	2	44	558	21	0	930	909
26**Pfura RDC	4	2303	4	27	599	69	0	3006	2937
26**Zaka RDC	27	1440	8	51	400	51	0	1977	1926
26**Zibagwe RDC	5	430	5	21	127	21	0	609	588
26**Zvimba RDC	27	6521	4	73	957	91	0	7673	7582
27**Bikita RDC	4	59	2	5	57	1	0	128	127
27**Buhera RDC	20	1917	9	74	542	84	0	2646	2562
27**Bulawayo City Council	39	1121	4	238	2548	44	0	3994	3950
27**Chaminuka RDC	3	1576	1	1	23	12	0	1616	1604
27**Chegutu RDC	2	844	2	22	247	57	0	1174	1117
27**Chikomba RDC	14	1450	9	71	440	42	0	2026	1984
27**Chipinge RDC	20	1054	8	82	444	78	0	1686	1608
27**Chiredzi RDC	11	1588	4	20	342	24	0	1989	1965
27**Chivi RDC	7	907	4	15	107	23	0	1063	1040
27**Gokwe North RDC	14	1046	6	29	256	54	0	1405	1351
27**Gokwe South RDC	25	1076	8	80	391	70	0	1650	1580
27**Gutu RDC	15	747	4	67	721	39	0	1593	1554
27**Harare Municipality	9	1245	5	146	4101	69	0	5575	5506
27**Kusile RDC	33	248	4	30	233	22	0	570	548
27**Makoni RDC	24	1018	11	72	789	32	0	1946	1914
27**Masvingo RDC	15	807	6	25	148	36	0	1037	1001
27**Mazowe RDC	25	2207	3	8	116	33	0	2392	2359
27**Mberengwa RDC	13	1214	0	21	182	17	0	1447	1430
27**Murewa RDC	16	1470	7	93	598	49	0	2233	2184
27**Mutare RDC	11	838	2	34	499	24	0	1408	1384
27**Mutasa RDC	1	190	0	8	167	0	0	366	366
27**Mutoko RDC	13	3424	2	15	109	76	0	3639	3563
27**Muzarabani RDC	3	1146	0	6	60	11	0	1226	1215
27**Nkayi RDC	6	135	3	47	437	14	0	642	628
27**Nyanga RDC	3	546	1	8	156	11	0	725	714
27**Pfura RDC	2	1466	0	9	179	18	0	1674	1656
27**Zaka RDC	37	1184	13	56	253	69	0	1612	1543
27**Zibagwe RDC	51	383	5	37	533	138	0	1147	1009
27**Zvimba RDC	8	729	0	10	184	9	0	940	931
28**Bikita RDC	1	383	1	13	235	11	0	644	633
28**Buhera RDC	24	1568	4	77	1141	110	0	2924	2814
28**Bulawayo City Council	93	1811	8	402	4031	68	1	6413	6345
28**Chaminuka RDC	3	977	2	9	111	17	0	1119	1102
28**Chegutu RDC	5	668	6	19	219	34	0	951	917
28**Chikomba RDC	5	841	3	29	242	31	0	1151	1120
28**Chipinge RDC	25	1604	24	174	1078	93	0	2998	2905
28**Chiredzi RDC	14	1868	4	28	771	22	0	2707	2685
28**Chivi RDC	25	1573	7	42	367	47	0	2061	2014
28**Gokwe North RDC	29	1384	11	74	593	126	0	2217	2091
28**Gokwe South RDC	5	463	0	7	57	17	0	549	532
28**Gutu RDC	9	888	8	45	376	19	0	1345	1326
28**Harare Municipality	2	786	1	53	3035	36	0	3913	3877
28**Kusile RDC	10	250	9	67	594	24	0	954	930
28**Makoni RDC	20	667	6	48	562	41	0	1344	1303
28**Masvingo RDC	25	1070	14	43	175	29	0	1356	1327
28**Mazowe RDC	10	1669	3	36	1063	56	0	2837	2781
28**Mberengwa RDC	20	1173	2	15	117	15	0	1342	1327
28**Murewa RDC	10	1418	11	57	448	42	0	1986	1944
28**Mutare RDC	25	1083	5	49	507	59	0	1728	1669
28**Mutasa RDC	18	534	3	37	316	36	0	944	908
28**Mutoko RDC	10	2194	0	8	81	19	0	2312	2293
28**Muzarabani RDC	7	1934	0	5	43	27	0	2016	1989
28**Nkayi RDC	14	103	1	41	283	21	0	463	442
28**Nyanga RDC	2	168	0	5	92	5	0	272	267
28**Pfura RDC	3	390	0	7	68	4	0	472	468
28**Zaka RDC	27	1073	6	46	416	64	0	1632	1568
28**Zibagwe RDC	5	299	6	49	219	34	0	612	578
28**Zvimba RDC	4	577	3	14	91	12	0	701	689
29**Bikita RDC	3	382	0	12	162	11	0	570	559
29**Buhera RDC	32	1718	10	83	896	49	0	2788	2739
29**Bulawayo City Council	99	717	4	517	3074	16	0	4427	4411
29**Chaminuka RDC	7	1559	1	23	793	47	0	2430	2383
29**Chegutu RDC	1	831	1	7	106	15	0	961	946
29**Chikomba RDC	17	1107	5	45	437	62	0	1673	1611
29**Chipinge RDC	19	1225	26	122	872	106	0	2370	2264
29**Chiredzi RDC	7	1659	5	18	247	30	0	1966	1936
29**Chivi RDC	15	1036	3	8	95	22	0	1179	1157
29**Gokwe North RDC	13	376	8	43	689	55	0	1184	1129
29**Gokwe South RDC	15	727	6	56	454	27	0	1285	1258
29**Gutu RDC	12	1251	3	25	232	28	0	1551	1523
29**Harare Municipality	4	636	2	94	2222	45	0	3003	2958
29**Makoni RDC	5	427	2	33	529	9	0	1005	996
29**Masvingo RDC	40	1678	9	49	312	59	0	2147	2088
29**Mazowe RDC	11	2346	2	5	83	33	0	2480	2447
29**Mberengwa RDC	22	1676	9	27	220	74	0	2028	1954
29**Murewa RDC	2	874	2	24	420	21	0	1343	1322
29**Mutare RDC	17	1573	9	66	737	32	0	2434	2402
29**Mutasa RDC	0	265	2	4	148	9	0	428	419
29**Mutoko RDC	20	4064	1	7	128	50	0	4270	4220
29**Muzarabani RDC	8	997	0	0	5	14	1	1024	1010
29**Nkayi RDC	17	496	2	94	693	19	0	1321	1302
29**Nyanga RDC	10	720	1	16	596	16	0	1359	1343
29**Pfura RDC	1	358	0	6	161	6	0	532	526
29**Zaka RDC	32	817	7	25	185	25	0	1091	1066
29**Zibagwe RDC	2	266	3	47	372	32	0	722	690
29**Zvimba RDC	6	1078	1	16	135	15	0	1251	1236
3**Beitbridge RDC	13	1610	13	28	90	83	0	1837	1754
3**Beitbridge Town Council	0	421	0	10	324	17	0	772	755
3**Bikita RDC	38	1387	16	92	646	56	0	2235	2179
3**Bindura Municipality	3	272	0	7	323	3	2	608	605
3**Bindura RDC	16	3411	0	3	79	61	0	3570	3509
3**Binga RDC	31	287	17	116	1072	128	0	1651	1523
3**Bubi RDC	11	374	7	83	481	35	0	991	956
3**Buhera RDC	9	1099	1	42	766	36	0	1953	1917
3**Bulawayo City Council	79	2256	3	502	3826	59	0	6725	6666
3**Bulilima RDC	23	480	17	101	341	18	0	980	962
3**Chaminuka RDC	3	1935	3	8	89	20	0	2058	2038
3**Chegutu Municipality	5	702	1	15	832	23	0	1578	1555
3**Chegutu RDC	5	917	3	52	754	25	0	1756	1731
3**Chikomba RDC	2	244	1	17	221	7	0	492	485
3**Chimanimani RDC	3	1012	5	40	724	25	0	1809	1784
3**Chinhoyi Municipality	6	940	1	12	1074	21	0	2054	2033
3**Chipinge RDC	13	1247	8	73	1409	63	0	2813	2750
3**Chipinge Town Council	3	370	0	19	427	7	0	826	819
3**Chiredzi RDC	15	1348	10	42	898	50	0	2363	2313
3**Chitungwiza Municipality	4	763	1	48	1217	29	0	2062	2033
3**Chivi RDC	14	788	2	33	657	43	0	1537	1494
3**Epworth Local Board	5	875	2	36	938	37	0	1893	1856
3**Gokwe North RDC	18	1359	5	44	369	55	0	1850	1795
3**Gokwe South RDC	10	640	3	21	217	19	0	910	891
3**Gokwe Town Council	2	577	1	5	481	7	0	1073	1066
3**Goromonzi RDC	18	1049	4	20	591	23	0	1705	1682
3**Guruve RDC	7	565	1	4	61	17	0	655	638
3**Gutu RDC	13	1209	3	14	169	23	0	1431	1408
3**Gwanda Municipality	3	122	0	32	161	3	0	321	318
3**Gwanda R.D.C	5	400	6	64	428	10	0	913	903
3**Gweru Municipality	9	392	3	17	569	12	0	1002	990
3**Harare Municipality	23	6747	15	226	6475	197	0	13683	13486
3**Hurungwe RDC	16	2033	3	9	76	54	0	2191	2137
3**Hwange Local Board	0	80	1	2	266	3	0	352	349
3**Hwange RDC	10	621	3	88	571	34	0	1327	1293
3**Insiza RDC	10	413	8	346	511	36	0	1324	1288
3**Kadoma City Council	2	792	2	20	820	27	0	1663	1636
3**Kariba Municipality	1	788	2	38	1252	30	0	2111	2081
3**Karoi Town Council	1	262	0	5	276	8	0	552	544
3**Kusile RDC	23	351	7	109	627	21	0	1138	1117
3**Kwekwe Municipality	2	991	2	60	1513	34	0	2602	2568
3**Makonde RDC	5	1167	0	1	34	16	0	1223	1207
3**Makoni RDC	24	1012	11	68	793	73	0	1981	1908
3**Mangwe RDC	9	359	10	82	410	8	0	878	870
3**Manyame RDC	15	865	7	40	703	16	0	1646	1630
3**Marondera Municipality	0	487	0	15	791	12	0	1305	1293
3**Marondera RDC	10	1755	1	8	120	25	0	1919	1894
3**Masvingo Municipality	4	1061	1	28	1469	32	0	2595	2563
3**Masvingo RDC	10	522	1	18	391	125	1	1067	942
3**Matobo RDC	17	406	4	72	468	20	0	987	967
3**Mazowe RDC	22	1446	2	23	217	63	0	1773	1710
3**Mberengwa RDC	25	1161	16	51	544	69	0	1866	1797
3**Mbire RDC	24	1523	10	34	192	70	0	1853	1783
3**Mhondoro-Ngezi RDC	5	942	3	54	395	25	0	1424	1399
3**Mudzi RDC	12	2974	2	13	119	24	0	3144	3120
3**Murewa RDC	8	1117	9	45	304	34	0	1517	1483
3**Mutare Municipality	0	662	2	33	1624	25	0	2346	2321
3**Mutare RDC	20	2924	8	37	615	61	0	3665	3604
3**Mutasa RDC	16	1137	8	73	774	36	0	2044	2008
3**Mutoko RDC	13	1688	2	23	176	61	0	1963	1902
3**Muzarabani RDC	4	1073	2	6	72	7	0	1164	1157
3**Mwenezi RDC	34	1524	6	54	387	36	0	2041	2005
3**Nkayi RDC	20	327	5	54	412	22	0	840	818
3**Norton Town Council	2	347	2	6	461	5	0	823	818
3**Nyaminyami RDC	22	928	27	60	1008	128	0	2173	2045
3**Nyanga RDC	14	1031	7	102	606	106	0	1866	1760
3**Pfura RDC	5	1058	5	16	177	96	0	1357	1261
3**Plumtree Town Council	9	353	1	48	509	9	0	929	920
3**Redcliff Municipality	2	167	1	20	610	8	0	808	800
3**Runde RDC	4	743	2	12	215	18	0	994	976
3**Rusape Town Council	0	217	0	8	239	4	0	468	464
3**Rushinga RDC	6	1290	2	2	33	28	0	1361	1333
3**Ruwa Local Board	0	350	0	8	758	11	0	1127	1116
3**Sanyati RDC	33	5171	7	47	691	145	0	6094	5949
3**Shurugwi Town Council	1	160	0	10	185	2	0	358	356
3**Takawira RDC	12	692	10	37	550	39	0	1340	1301
3**Tongogara RDC	0	123	0	2	51	5	0	181	176
3**Tsholotsho RDC	14	516	13	93	559	29	0	1224	1195
3**Umguza RDC	45	396	2	115	565	52	1	1175	1123
3**Umzingwane RDC	30	487	9	120	708	44	0	1398	1354
3**Victoria Falls Municipality	3	131	0	7	129	3	0	273	270
3**Vungu RDC	13	699	21	181	741	20	0	1675	1655
3**Wedza RDC	9	1231	1	6	59	10	0	1316	1306
3**Zaka RDC	8	1296	7	41	462	67	0	1881	1814
3**Zibagwe RDC	9	1353	2	15	104	24	0	1507	1483
3**Zvataida RDC	14	2391	2	4	58	10	0	2479	2469
3**Zvimba RDC	12	1788	3	19	203	23	0	2048	2025
3**Zvishavane Town Council	0	340	2	11	420	8	3	781	773
30**Bikita RDC	0	174	1	4	226	1	0	406	405
30**Buhera RDC	7	425	5	62	580	48	0	1127	1079
30**Chikomba RDC	2	793	2	23	283	10	0	1113	1103
30**Chipinge RDC	11	248	21	117	405	64	0	866	802
30**Chiredzi RDC	29	1883	6	60	576	32	0	2586	2554
30**Chivi RDC	7	852	2	17	704	17	0	1599	1582
30**Gokwe North RDC	34	844	8	39	566	46	0	1537	1491
30**Gokwe South RDC	12	681	8	62	424	41	0	1228	1187
30**Gutu RDC	13	896	6	31	458	32	0	1436	1404
30**Harare Municipality	11	2401	10	212	7943	89	0	10666	10577
30**Makoni RDC	23	978	15	65	925	51	0	2057	2006
30**Masvingo RDC	11	1848	12	20	213	64	0	2168	2104
30**Mazowe RDC	12	2293	3	13	73	52	0	2446	2394
30**Mberengwa RDC	17	1071	3	33	273	29	0	1426	1397
30**Murewa RDC	5	1952	2	21	962	29	0	2971	2942
30**Mutare RDC	20	1597	6	74	958	47	0	2702	2655
30**Mutasa RDC	10	726	6	49	561	55	0	1407	1352
30**Nkayi RDC	5	159	3	45	321	18	0	551	533
30**Nyanga RDC	5	554	2	25	439	21	0	1046	1025
30**Pfura RDC	1	275	0	6	112	5	0	399	394
30**Zaka RDC	12	1316	1	50	406	37	0	1822	1785
30**Zibagwe RDC	2	1487	3	9	163	39	0	1703	1664
30**Zvimba RDC	14	2026	3	4	93	44	0	2184	2140
31**Bikita RDC	9	891	8	86	600	50	0	1644	1594
31**Buhera RDC	14	819	4	51	728	31	0	1647	1616
31**Chiredzi RDC	17	1239	6	42	469	62	0	1835	1773
31**Chivi RDC	10	811	7	29	274	23	0	1154	1131
31**Gokwe North RDC	18	534	11	47	1010	97	0	1717	1620
31**Gokwe South RDC	10	921	3	19	193	29	0	1175	1146
31**Gutu RDC	14	694	3	71	505	24	0	1311	1287
31**Harare Municipality	4	1103	6	136	3851	60	0	5160	5100
31**Makoni RDC	22	1719	6	28	257	51	0	2083	2032
31**Masvingo RDC	4	504	0	16	296	9	0	829	820
31**Mazowe RDC	17	1485	5	18	224	33	0	1782	1749
31**Mberengwa RDC	28	1006	8	69	327	70	0	1508	1438
31**Mutare RDC	1	522	0	11	472	18	0	1024	1006
31**Mutasa RDC	6	581	1	18	525	28	0	1159	1131
31**Nyanga RDC	1	789	0	4	265	10	0	1069	1059
31**Pfura RDC	10	2002	3	9	44	28	0	2096	2068
31**Zaka RDC	23	1013	2	46	636	26	0	1746	1720
31**Zibagwe RDC	13	1810	7	21	608	37	0	2496	2459
31**Zvimba RDC	13	2065	3	15	80	16	0	2192	2176
32**Bikita RDC	7	921	14	37	404	34	0	1417	1383
32**Buhera RDC	15	955	6	74	490	81	0	1621	1540
32**Chiredzi RDC	16	1891	7	14	165	29	0	2122	2093
32**Chivi RDC	18	910	14	41	333	16	0	1332	1316
32**Gokwe North RDC	6	900	3	26	72	7	0	1014	1007
32**Gokwe South RDC	9	816	9	40	409	16	0	1299	1283
32**Gutu RDC	18	2373	2	14	287	33	0	2727	2694
32**Harare Municipality	16	1584	8	193	4959	85	0	6845	6760
32**Makoni RDC	0	252	1	7	298	6	0	564	558
32**Masvingo RDC	4	1154	2	17	324	6	0	1507	1501
32**Mazowe RDC	12	1467	5	11	129	38	0	1662	1624
32**Mberengwa RDC	14	511	3	69	535	43	0	1175	1132
32**Mutare RDC	2	748	0	13	791	13	0	1567	1554
32**Pfura RDC	4	1075	1	9	37	16	0	1142	1126
32**Zaka RDC	19	1164	6	39	242	30	4	1500	1470
32**Zibagwe RDC	3	802	0	18	275	14	0	1112	1098
32**Zvimba RDC	7	1358	1	6	242	30	0	1644	1614
33**Buhera RDC	18	1001	8	101	1169	78	0	2375	2297
33**Gokwe North RDC	28	1517	10	29	188	34	0	1806	1772
33**Gokwe South RDC	10	1172	2	41	271	53	0	1549	1496
33**Gutu RDC	2	524	1	8	513	6	0	1054	1048
33**Harare Municipality	20	2430	6	208	7613	136	0	10413	10277
33**Makoni RDC	2	366	0	7	377	5	0	757	752
33**Masvingo RDC	5	847	1	25	712	14	0	1604	1590
33**Mazowe RDC	1	1084	3	27	859	17	0	1991	1974
33**Mberengwa RDC	9	723	2	18	174	35	0	961	926
33**Mutare RDC	6	599	3	26	362	17	0	1013	996
33**Pfura RDC	9	2217	6	13	73	57	0	2375	2318
33**Zaka RDC	18	1065	2	36	332	32	0	1485	1453
33**Zibagwe RDC	41	285	8	93	563	60	0	1050	990
33**Zvimba RDC	6	1501	3	8	99	88	0	1705	1617
34**Gokwe North RDC	14	1085	7	41	331	39	0	1517	1478
34**Gutu RDC	7	1586	0	16	715	11	0	2335	2324
34**Harare Municipality	12	808	2	93	2609	52	0	3576	3524
34**Makoni RDC	9	1473	6	15	177	38	0	1718	1680
34**Masvingo RDC	21	1434	4	20	197	51	0	1727	1676
34**Mazowe RDC	7	1062	2	8	87	14	0	1180	1166
34**Mberengwa RDC	10	577	6	32	218	45	0	888	843
34**Mutare RDC	26	3566	9	40	419	88	0	4148	4060
34**Pfura RDC	10	1871	5	20	120	34	0	2060	2026
34**Zaka RDC	9	785	1	26	328	27	0	1176	1149
34**Zvimba RDC	12	1046	7	29	279	38	0	1411	1373
35**Gokwe North RDC	21	1534	16	54	307	70	0	2002	1932
35**Gutu RDC	3	806	6	26	262	8	0	1111	1103
35**Harare Municipality	17	1185	4	140	3781	83	9	5210	5127
35**Makoni RDC	16	2047	4	44	634	73	0	2818	2745
35**Masvingo RDC	1	299	3	23	945	18	0	1289	1271
35**Mazowe RDC	2	687	0	19	398	18	0	1124	1106
35**Mberengwa RDC	13	1868	1	8	63	24	0	1977	1953
35**Mutare RDC	5	758	4	46	894	25	0	1732	1707
35**Pfura RDC	4	1163	1	11	91	15	0	1285	1270
35**Zvimba RDC	13	2975	7	109	2302	79	2	5485	5406
36**Gokwe North RDC	21	1431	9	48	403	72	0	1984	1912
36**Gutu RDC	17	994	7	60	432	32	0	1542	1510
36**Harare Municipality	13	963	3	62	1906	43	0	2990	2947
36**Makoni RDC	7	840	5	35	437	35	0	1359	1324
36**Mberengwa RDC	9	2317	2	10	171	30	0	2539	2509
36**Mutare RDC	17	904	7	39	343	12	0	1322	1310
36**Pfura RDC	7	2744	2	25	158	55	0	2991	2936
37**Gutu RDC	10	946	8	31	413	23	0	1431	1408
37**Harare Municipality	18	2663	7	257	8164	132	0	11241	11109
37**Makoni RDC	24	1892	3	39	259	55	0	2272	2217
37**Mberengwa RDC	0	165	0	5	64	7	0	241	234
37**Pfura RDC	6	1054	1	5	38	17	0	1121	1104
38**Gutu RDC	10	535	4	27	327	7	0	910	903
38**Harare Municipality	10	1925	5	133	4047	47	0	6167	6120
38**Makoni RDC	14	894	1	12	154	22	0	1097	1075
38**Pfura RDC	9	1509	0	13	62	13	0	1606	1593
39**Gutu RDC	1	664	1	20	249	10	0	945	935
39**Harare Municipality	7	1136	8	110	2760	61	0	4082	4021
39**Makoni RDC	17	640	6	52	483	20	0	1218	1198
39**Pfura RDC	1	1937	0	1	21	11	0	1971	1960
4**Beitbridge RDC	25	991	9	50	232	74	0	1381	1307
4**Beitbridge Town Council	12	868	0	47	689	39	0	1655	1616
4**Bikita RDC	13	980	4	54	381	44	0	1476	1432
4**Bindura Municipality	1	447	0	7	387	12	0	854	842
4**Bindura RDC	16	1981	1	8	63	26	0	2095	2069
4**Binga RDC	4	103	12	95	684	74	0	972	898
4**Bubi RDC	10	401	3	67	517	48	0	1046	998
4**Buhera RDC	13	967	4	30	890	21	0	1925	1904
4**Bulawayo City Council	70	1069	12	643	3751	73	0	5618	5545
4**Bulilima RDC	15	332	11	173	387	24	0	942	918
4**Chaminuka RDC	11	818	3	11	120	14	0	977	963
4**Chegutu Municipality	0	537	4	24	636	30	0	1231	1201
4**Chegutu RDC	12	1413	5	100	1134	35	0	2699	2664
4**Chikomba RDC	6	445	2	14	163	24	0	654	630
4**Chimanimani RDC	20	1806	6	91	889	50	0	2862	2812
4**Chinhoyi Municipality	1	749	4	23	909	18	0	1704	1686
4**Chipinge RDC	26	1346	9	53	672	42	0	2148	2106
4**Chipinge Town Council	1	401	0	10	486	11	0	909	898
4**Chiredzi RDC	19	1797	10	54	1306	61	0	3247	3186
4**Chitungwiza Municipality	3	1367	4	56	1923	46	0	3399	3353
4**Chivi RDC	5	845	1	18	235	26	0	1130	1104
4**Epworth Local Board	6	1418	7	56	991	42	0	2520	2478
4**Gokwe North RDC	31	1726	10	37	329	63	0	2196	2133
4**Gokwe South RDC	20	1757	9	49	557	49	0	2441	2392
4**Gokwe Town Council	1	336	0	7	277	3	0	624	621
4**Goromonzi RDC	18	2676	8	121	2580	105	0	5508	5403
4**Guruve RDC	12	1622	0	9	125	15	0	1783	1768
4**Gutu RDC	3	407	4	20	309	7	0	750	743
4**Gwanda Municipality	1	448	2	64	428	4	0	947	943
4**Gwanda R.D.C	18	356	14	192	556	22	0	1158	1136
4**Gweru Municipality	12	1192	1	40	1569	32	0	2846	2814
4**Harare Municipality	17	7015	10	219	6098	216	0	13575	13359
4**Hurungwe RDC	22	1501	7	27	369	49	0	1975	1926
4**Hwange Local Board	3	109	0	12	228	2	0	354	352
4**Hwange RDC	10	442	5	68	381	19	0	925	906
4**Insiza RDC	20	440	8	199	404	22	0	1093	1071
4**Kadoma City Council	5	482	2	13	580	20	0	1102	1082
4**Kariba Municipality	2	208	1	9	433	7	0	660	653
4**Karoi Town Council	1	312	3	9	455	15	0	795	780
4**Kusile RDC	17	324	6	24	292	11	0	674	663
4**Kwekwe Municipality	0	497	1	10	725	14	0	1247	1233
4**Makonde RDC	16	3090	5	21	152	60	0	3344	3284
4**Makoni RDC	0	110	0	2	93	1	0	206	205
4**Mangwe RDC	10	599	11	51	285	16	0	972	956
4**Manyame RDC	12	1261	10	90	1057	35	0	2465	2430
4**Marondera Municipality	6	720	1	8	918	9	0	1662	1653
4**Marondera RDC	4	990	3	12	558	22	0	1589	1567
4**Masvingo Municipality	7	1078	0	35	1596	19	0	2735	2716
4**Masvingo RDC	2	221	2	3	87	2	0	317	315
4**Matobo RDC	20	701	8	76	626	34	0	1465	1431
4**Mazowe RDC	29	1017	4	20	192	44	0	1306	1262
4**Mberengwa RDC	20	1561	14	65	582	28	0	2270	2242
4**Mbire RDC	31	1679	6	42	277	49	0	2084	2035
4**Mhondoro-Ngezi RDC	6	1434	4	25	361	88	0	1918	1830
4**Mudzi RDC	19	3389	3	22	89	31	0	3553	3522
4**Murewa RDC	10	1180	6	37	339	32	0	1604	1572
4**Mutare Municipality	2	845	5	41	1844	27	0	2764	2737
4**Mutare RDC	7	640	3	49	460	24	0	1183	1159
4**Mutasa RDC	5	732	3	46	738	39	0	1563	1524
4**Mutoko RDC	9	1260	4	15	140	13	0	1441	1428
4**Muzarabani RDC	4	1414	4	16	124	12	0	1574	1562
4**Mwenezi RDC	6	1610	4	29	218	36	0	1903	1867
4**Nkayi RDC	6	291	10	56	418	19	0	800	781
4**Norton Town Council	2	677	2	28	1072	15	4	1796	1781
4**Nyaminyami RDC	36	898	24	78	874	110	0	2020	1910
4**Nyanga RDC	9	1317	6	56	833	68	0	2289	2221
4**Pfura RDC	6	1674	2	17	77	40	0	1816	1776
4**Plumtree Town Council	7	369	1	25	392	19	0	813	794
4**Redcliff Municipality	1	229	0	23	780	16	0	1049	1033
4**Runde RDC	16	738	5	19	252	26	0	1056	1030
4**Rusape Town Council	3	303	1	8	493	9	0	817	808
4**Rushinga RDC	4	1077	1	3	26	14	0	1125	1111
4**Ruwa Local Board	0	225	0	3	512	9	0	749	740
4**Sanyati RDC	4	1711	0	13	102	24	0	1854	1830
4**Shurugwi Town Council	3	94	0	8	142	7	0	254	247
4**Takawira RDC	2	555	0	16	168	9	0	750	741
4**Tongogara RDC	1	141	0	4	93	6	0	245	239
4**Tsholotsho RDC	12	346	7	71	413	31	0	880	849
4**Umguza RDC	30	223	2	61	544	37	0	897	860
4**Umzingwane RDC	11	582	7	72	513	14	0	1199	1185
4**Victoria Falls Municipality	6	244	2	22	360	7	0	641	634
4**Vungu RDC	2	377	3	69	474	22	0	947	925
4**Wedza RDC	8	1144	3	13	166	28	0	1362	1334
4**Zaka RDC	25	1330	12	97	649	107	0	2220	2113
4**Zibagwe RDC	8	727	2	12	236	43	0	1028	985
4**Zvataida RDC	32	4554	8	10	64	41	0	4709	4668
4**Zvimba RDC	9	966	3	15	146	21	0	1160	1139
4**Zvishavane Town Council	2	309	1	8	772	12	0	1104	1092
40**Gutu RDC	9	728	4	37	363	42	0	1183	1141
40**Harare Municipality	23	4362	7	221	4707	152	0	9472	9320
40**Pfura RDC	3	2341	2	2	40	39	0	2427	2388
41**Gutu RDC	10	520	2	24	329	31	0	916	885
41**Harare Municipality	14	1791	2	115	5388	71	0	7381	7310
42**Harare Municipality	21	5460	12	152	5947	170	0	11762	11592
43**Harare Municipality	13	3485	4	190	6671	150	0	10513	10363
44**Harare Municipality	7	1179	3	118	2843	35	0	4185	4150
45**Harare Municipality	2	1152	0	79	2502	42	0	3777	3735
46**Harare Municipality	7	1290	4	85	1552	58	0	2996	2938
5**Beitbridge RDC	38	1310	17	65	355	65	0	1850	1785
5**Beitbridge Town Council	11	523	2	38	615	8	0	1197	1189
5**Bikita RDC	13	1022	11	64	442	64	0	1616	1552
5**Bindura Municipality	2	465	2	10	515	9	0	1003	994
5**Bindura RDC	17	1538	3	4	40	33	0	1635	1602
5**Binga RDC	5	475	9	69	991	93	0	1642	1549
5**Bubi RDC	4	228	4	22	163	19	0	440	421
5**Buhera RDC	13	1542	6	75	1394	44	0	3074	3030
5**Bulawayo City Council	58	929	6	318	2820	34	0	4165	4131
5**Bulilima RDC	18	337	18	60	692	22	0	1147	1125
5**Chaminuka RDC	2	1535	5	11	100	39	0	1692	1653
5**Chegutu Municipality	0	265	0	13	271	5	0	554	549
5**Chegutu RDC	4	621	3	50	493	25	0	1196	1171
5**Chikomba RDC	5	575	1	56	504	25	1	1166	1141
5**Chimanimani RDC	10	1202	6	56	801	51	0	2126	2075
5**Chinhoyi Municipality	4	872	4	35	959	21	0	1895	1874
5**Chipinge RDC	23	882	11	49	413	32	0	1410	1378
5**Chipinge Town Council	2	368	2	9	297	17	0	695	678
5**Chiredzi RDC	6	1247	10	65	1163	86	0	2577	2491
5**Chitungwiza Municipality	5	649	3	33	955	17	0	1662	1645
5**Chivi RDC	19	1004	3	51	364	32	0	1473	1441
5**Epworth Local Board	3	1620	1	52	1315	35	0	3026	2991
5**Gokwe North RDC	40	2291	9	34	209	69	0	2652	2583
5**Gokwe South RDC	29	1959	22	98	533	55	0	2696	2641
5**Gokwe Town Council	4	614	0	8	712	9	0	1347	1338
5**Goromonzi RDC	7	1117	2	24	888	20	0	2058	2038
5**Guruve RDC	9	1817	5	38	348	22	0	2239	2217
5**Gutu RDC	10	757	5	41	481	31	0	1325	1294
5**Gwanda Municipality	2	167	0	17	162	3	0	351	348
5**Gwanda R.D.C	3	130	2	112	209	4	0	460	456
5**Gweru Municipality	8	977	1	28	1477	25	0	2516	2491
5**Harare Municipality	7	1750	3	90	2916	43	0	4809	4766
5**Hurungwe RDC	9	945	2	5	33	22	0	1016	994
5**Hwange Local Board	1	129	1	13	336	5	0	485	480
5**Hwange RDC	10	363	5	56	549	31	0	1014	983
5**Insiza RDC	19	453	7	181	214	7	0	881	874
5**Kadoma City Council	3	589	0	26	903	27	0	1548	1521
5**Kariba Municipality	2	244	1	4	468	13	0	732	719
5**Karoi Town Council	1	319	1	11	373	15	0	720	705
5**Kusile RDC	12	409	12	59	446	48	0	986	938
5**Kwekwe Municipality	2	877	1	43	1363	31	0	2317	2286
5**Makonde RDC	13	2610	5	11	113	37	0	2789	2752
5**Makoni RDC	20	1509	9	127	1292	111	0	3068	2957
5**Mangwe RDC	27	418	9	72	296	21	0	843	822
5**Manyame RDC	2	509	4	14	323	25	0	877	852
5**Marondera Municipality	3	445	1	6	702	4	0	1161	1157
5**Marondera RDC	8	1589	4	17	195	29	0	1842	1813
5**Masvingo Municipality	4	799	2	19	1212	27	0	2063	2036
5**Masvingo RDC	4	770	3	24	1070	40	0	1911	1871
5**Matobo RDC	20	373	16	83	438	23	0	953	930
5**Mazowe RDC	20	1420	2	28	224	19	0	1713	1694
5**Mberengwa RDC	26	1491	5	40	353	51	0	1966	1915
5**Mbire RDC	16	1559	7	14	116	56	0	1768	1712
5**Mhondoro-Ngezi RDC	5	1237	7	25	496	77	0	1847	1770
5**Mudzi RDC	6	2701	2	11	71	31	0	2822	2791
5**Murewa RDC	7	903	3	18	292	25	0	1248	1223
5**Mutare Municipality	3	760	0	37	2027	26	0	2853	2827
5**Mutare RDC	19	872	5	61	799	73	0	1829	1756
5**Mutasa RDC	15	1106	3	62	776	38	0	2000	1962
5**Mutoko RDC	5	1409	1	12	172	80	0	1679	1599
5**Muzarabani RDC	10	1144	1	7	118	21	0	1301	1280
5**Mwenezi RDC	37	1751	10	61	661	91	0	2611	2520
5**Nkayi RDC	26	467	16	137	712	42	0	1400	1358
5**Norton Town Council	1	418	1	8	612	15	0	1055	1040
5**Nyaminyami RDC	7	785	1	11	183	14	0	1001	987
5**Nyanga RDC	8	888	2	41	774	52	0	1765	1713
5**Pfura RDC	5	1199	0	1	23	18	0	1246	1228
5**Plumtree Town Council	3	641	0	7	105	6	0	762	756
5**Redcliff Municipality	9	859	1	37	1093	17	0	2016	1999
5**Runde RDC	4	546	0	16	217	17	0	800	783
5**Rusape Town Council	2	244	0	7	320	6	0	579	573
5**Rushinga RDC	4	902	1	0	13	8	0	928	920
5**Ruwa Local Board	1	237	1	10	504	3	0	756	753
5**Sanyati RDC	23	4797	8	16	137	194	0	5175	4981
5**Shurugwi Town Council	3	453	0	4	305	10	0	775	765
5**Takawira RDC	7	521	4	25	423	20	0	1000	980
5**Tongogara RDC	7	642	1	22	328	24	0	1024	1000
5**Tsholotsho RDC	8	390	12	73	681	31	0	1195	1164
5**Umguza RDC	8	1424	0	49	539	25	1	2045	2020
5**Umzingwane RDC	24	316	10	142	519	17	0	1028	1011
5**Victoria Falls Municipality	5	180	2	20	400	4	0	611	607
5**Vungu RDC	8	220	5	69	191	7	0	500	493
5**Wedza RDC	16	1511	7	86	610	28	0	2258	2230
5**Zaka RDC	19	911	6	68	482	36	0	1522	1486
5**Zibagwe RDC	3	1022	1	6	49	26	0	1107	1081
5**Zvataida RDC	13	2105	2	5	32	16	0	2173	2157
5**Zvimba RDC	7	1064	5	19	133	12	0	1240	1228
5**Zvishavane Town Council	1	325	2	19	458	11	0	816	805
6**Beitbridge RDC	25	1345	12	42	227	34	0	1685	1651
6**Beitbridge Town Council	6	581	2	26	511	13	0	1139	1126
6**Bikita RDC	21	677	5	71	498	36	0	1308	1272
6**Bindura Municipality	1	512	2	15	563	22	0	1115	1093
6**Bindura RDC	5	1012	3	33	1477	29	0	2559	2530
6**Binga RDC	9	184	9	136	1625	110	0	2073	1963
6**Bubi RDC	3	14	0	2	21	3	0	43	40
6**Buhera RDC	10	1103	3	75	1364	55	0	2610	2555
6**Bulawayo City Council	46	776	4	254	2335	40	0	3455	3415
6**Bulilima RDC	8	524	6	35	274	24	0	871	847
6**Chaminuka RDC	13	1506	1	11	86	43	0	1660	1617
6**Chegutu Municipality	1	508	2	14	769	28	0	1322	1294
6**Chegutu RDC	6	602	1	15	243	15	0	882	867
6**Chikomba RDC	9	477	1	40	365	13	0	905	892
6**Chimanimani RDC	3	610	2	25	323	8	0	971	963
6**Chinhoyi Municipality	3	409	0	5	469	8	0	894	886
6**Chipinge RDC	49	2803	12	85	474	72	0	3495	3423
6**Chipinge Town Council	2	523	0	17	450	23	0	1015	992
6**Chiredzi RDC	26	1666	20	31	634	83	0	2460	2377
6**Chitungwiza Municipality	10	1785	2	43	2255	41	0	4136	4095
6**Chivi RDC	1	389	1	2	163	10	0	566	556
6**Epworth Local Board	3	2093	6	66	1594	122	0	3884	3762
6**Gokwe North RDC	12	1261	5	25	245	34	0	1582	1548
6**Gokwe South RDC	15	1143	15	26	211	47	0	1457	1410
6**Gokwe Town Council	0	152	0	1	152	19	0	324	305
6**Goromonzi RDC	6	2054	1	39	991	32	0	3123	3091
6**Guruve RDC	17	1980	7	54	813	45	0	2916	2871
6**Gutu RDC	13	788	3	77	512	50	0	1443	1393
6**Gwanda Municipality	10	200	2	45	409	2	0	668	666
6**Gwanda R.D.C	16	338	13	226	675	21	0	1289	1268
6**Gweru Municipality	8	1058	2	36	1282	29	0	2415	2386
6**Harare Municipality	9	1334	3	57	2706	31	0	4140	4109
6**Hurungwe RDC	18	2030	6	17	254	39	0	2364	2325
6**Hwange Local Board	1	298	2	18	612	16	0	947	931
6**Hwange RDC	3	343	6	61	404	34	0	851	817
6**Insiza RDC	23	515	7	88	245	8	0	886	878
6**Kadoma City Council	2	946	0	42	1239	55	0	2284	2229
6**Kariba Municipality	2	255	1	18	304	4	0	584	580
6**Karoi Town Council	0	204	0	7	263	7	0	481	474
6**Kusile RDC	11	400	0	42	348	17	0	818	801
6**Kwekwe Municipality	12	1041	3	57	759	71	0	1943	1872
6**Makonde RDC	3	1417	3	4	92	34	0	1553	1519
6**Makoni RDC	10	2112	4	12	243	38	0	2419	2381
6**Mangwe RDC	64	609	21	98	236	32	0	1060	1028
6**Manyame RDC	9	544	1	15	373	14	0	956	942
6**Marondera Municipality	0	534	2	11	639	7	0	1193	1186
6**Marondera RDC	14	1763	0	13	271	24	0	2085	2061
6**Masvingo Municipality	4	1040	2	26	1214	29	0	2315	2286
6**Masvingo RDC	23	1969	3	23	559	45	0	2622	2577
6**Matobo RDC	58	413	17	104	552	33	0	1177	1144
6**Mazowe RDC	15	996	6	45	304	28	0	1394	1366
6**Mberengwa RDC	25	1774	13	77	266	52	0	2207	2155
6**Mbire RDC	12	1031	4	26	150	16	0	1239	1223
6**Mhondoro-Ngezi RDC	10	1023	5	24	403	112	0	1577	1465
6**Mudzi RDC	16	2343	0	10	100	33	0	2502	2469
6**Murewa RDC	0	262	0	4	53	4	0	323	319
6**Mutare Municipality	2	601	1	17	1055	8	0	1684	1676
6**Mutare RDC	4	1048	7	58	867	33	0	2017	1984
6**Mutasa RDC	14	929	7	66	651	29	0	1696	1667
6**Mutoko RDC	9	954	1	13	123	9	1	1109	1100
6**Muzarabani RDC	2	719	1	8	50	15	0	795	780
6**Mwenezi RDC	21	1077	0	7	76	32	0	1213	1181
6**Nkayi RDC	28	347	8	63	508	31	0	985	954
6**Norton Town Council	3	304	0	18	511	16	0	852	836
6**Nyaminyami RDC	11	417	12	42	327	58	0	867	809
6**Nyanga RDC	10	752	3	49	514	43	0	1371	1328
6**Pfura RDC	5	1459	0	4	12	22	0	1502	1480
6**Plumtree Town Council	12	179	1	39	259	10	0	500	490
6**Redcliff Municipality	7	1072	1	55	1222	32	0	2389	2357
6**Runde RDC	6	788	4	32	433	14	0	1277	1263
6**Rusape Town Council	2	503	1	22	696	21	0	1245	1224
6**Rushinga RDC	0	888	0	4	12	25	0	929	904
6**Ruwa Local Board	0	238	0	7	523	4	0	772	768
6**Sanyati RDC	1	1108	3	10	197	23	0	1342	1319
6**Shurugwi Town Council	1	192	0	3	239	11	0	446	435
6**Takawira RDC	1	609	5	32	468	19	0	1134	1115
6**Tongogara RDC	1	356	2	0	36	4	0	399	395
6**Tsholotsho RDC	26	568	21	172	835	44	0	1666	1622
6**Umguza RDC	11	410	5	59	439	24	0	948	924
6**Umzingwane RDC	32	260	2	70	547	16	0	927	911
6**Victoria Falls Municipality	7	146	0	16	271	5	0	445	440
6**Vungu RDC	15	434	5	118	651	11	0	1234	1223
6**Wedza RDC	35	1286	12	114	618	62	0	2127	2065
6**Zaka RDC	13	741	6	57	363	36	0	1216	1180
6**Zibagwe RDC	19	1581	6	32	437	52	0	2127	2075
6**Zvataida RDC	8	2609	3	12	269	27	0	2928	2901
6**Zvimba RDC	10	1758	1	9	176	31	0	1985	1954
6**Zvishavane Town Council	2	398	0	8	523	6	0	937	931
7**Beitbridge RDC	15	499	5	22	103	19	0	663	644
7**Bikita RDC	28	1035	6	37	306	43	0	1455	1412
7**Bindura Municipality	2	316	1	3	338	9	0	669	660
7**Bindura RDC	7	1573	1	6	77	24	1	1688	1664
7**Binga RDC	15	565	18	86	878	111	0	1673	1562
7**Bubi RDC	10	267	4	89	476	39	0	885	846
7**Buhera RDC	10	851	7	56	825	50	0	1799	1749
7**Bulawayo City Council	50	1795	6	304	3710	66	0	5931	5865
7**Bulilima RDC	40	750	19	80	447	37	0	1373	1336
7**Chaminuka RDC	4	819	4	24	179	39	0	1069	1030
7**Chegutu Municipality	1	576	1	25	791	30	0	1424	1394
7**Chegutu RDC	5	985	2	23	324	27	0	1366	1339
7**Chikomba RDC	12	3402	3	10	132	35	0	3594	3559
7**Chimanimani RDC	15	1727	6	28	234	43	0	2053	2010
7**Chinhoyi Municipality	2	824	0	18	711	17	0	1572	1555
7**Chipinge RDC	13	1360	0	32	261	63	0	1729	1666
7**Chipinge Town Council	2	862	1	7	496	16	0	1384	1368
7**Chiredzi RDC	23	1595	7	36	669	72	0	2402	2330
7**Chitungwiza Municipality	8	687	2	32	1278	24	0	2031	2007
7**Chivi RDC	7	647	0	34	309	27	0	1024	997
7**Epworth Local Board	5	2973	5	81	1582	257	0	4903	4646
7**Gokwe North RDC	20	1699	11	35	401	39	0	2205	2166
7**Gokwe South RDC	6	657	8	28	409	33	0	1141	1108
7**Goromonzi RDC	5	984	1	9	254	11	0	1264	1253
7**Guruve RDC	11	1416	3	57	488	42	0	2017	1975
7**Gutu RDC	16	2086	0	8	96	40	0	2246	2206
7**Gwanda Municipality	10	409	1	108	629	6	0	1163	1157
7**Gwanda R.D.C	6	214	5	106	380	11	0	722	711
7**Gweru Municipality	6	632	1	21	1144	24	0	1828	1804
7**Harare Municipality	23	7780	6	95	3915	137	2	11956	11819
7**Hurungwe RDC	9	1794	11	41	668	58	0	2581	2523
7**Hwange Local Board	5	967	0	5	149	12	0	1138	1126
7**Hwange RDC	14	510	12	71	510	59	0	1176	1117
7**Insiza RDC	19	447	10	156	262	17	0	911	894
7**Kadoma City Council	5	500	0	27	479	30	0	1041	1011
7**Kariba Municipality	0	274	1	5	239	4	0	523	519
7**Karoi Town Council	2	437	2	12	330	16	0	799	783
7**Kusile RDC	5	270	3	79	116	20	0	493	473
7**Kwekwe Municipality	3	555	0	21	683	10	0	1272	1262
7**Makonde RDC	3	525	2	9	371	19	0	929	910
7**Makoni RDC	32	2019	6	58	659	62	0	2836	2774
7**Mangwe RDC	21	168	4	98	345	36	0	672	636
7**Manyame RDC	7	699	5	45	661	22	0	1439	1417
7**Marondera Municipality	2	585	0	26	766	10	0	1389	1379
7**Marondera RDC	10	1791	1	4	99	42	0	1947	1905
7**Masvingo Municipality	5	1362	1	44	2060	63	0	3535	3472
7**Masvingo RDC	4	671	2	15	209	22	0	923	901
7**Matobo RDC	50	305	8	69	448	9	0	889	880
7**Mazowe RDC	13	1269	4	30	542	29	0	1887	1858
7**Mberengwa RDC	15	1034	4	24	250	43	0	1370	1327
7**Mbire RDC	10	935	2	17	125	56	0	1145	1089
7**Mhondoro-Ngezi RDC	5	615	4	17	272	14	0	927	913
7**Mudzi RDC	21	3403	6	41	328	62	0	3861	3799
7**Murewa RDC	1	205	0	3	86	4	0	299	295
7**Mutare Municipality	3	1135	1	20	1007	19	0	2185	2166
7**Mutare RDC	30	1156	15	58	278	51	0	1588	1537
7**Mutasa RDC	24	945	11	117	923	34	0	2054	2020
7**Mutoko RDC	15	1565	3	24	274	30	0	1911	1881
7**Muzarabani RDC	1	438	1	9	42	11	0	502	491
7**Mwenezi RDC	34	1499	7	47	228	80	0	1895	1815
7**Nkayi RDC	30	508	7	57	359	39	0	1000	961
7**Norton Town Council	3	759	3	27	803	18	0	1613	1595
7**Nyaminyami RDC	2	576	1	4	89	10	0	682	672
7**Nyanga RDC	4	670	6	53	586	48	0	1367	1319
7**Pfura RDC	24	1528	5	29	184	43	0	1813	1770
7**Redcliff Municipality	0	183	0	8	394	12	0	597	585
7**Runde RDC	8	711	1	37	424	23	0	1204	1181
7**Rusape Town Council	1	118	1	0	156	2	0	278	276
7**Rushinga RDC	10	1731	1	11	55	30	0	1838	1808
7**Ruwa Local Board	3	412	1	6	984	13	0	1419	1406
7**Sanyati RDC	1	464	2	4	33	28	0	532	504
7**Shurugwi Town Council	1	191	0	3	284	7	0	486	479
7**Takawira RDC	3	595	2	20	290	16	0	926	910
7**Tongogara RDC	2	637	2	14	296	31	0	982	951
7**Tsholotsho RDC	14	620	6	88	422	49	0	1199	1150
7**Umguza RDC	16	929	1	66	1080	61	0	2153	2092
7**Umzingwane RDC	7	257	2	57	446	36	0	805	769
7**Victoria Falls Municipality	8	201	0	18	336	4	0	567	563
7**Vungu RDC	3	416	7	41	728	27	0	1222	1195
7**Wedza RDC	13	1292	5	51	599	30	0	1990	1960
7**Zaka RDC	5	583	8	26	189	33	0	844	811
7**Zibagwe RDC	8	868	8	43	708	29	0	1664	1635
7**Zvataida RDC	4	1625	2	1	14	8	244	1654	1646
7**Zvimba RDC	8	1452	1	12	122	18	0	1613	1595
7**Zvishavane Town Council	2	428	1	31	976	21	0	1459	1438
8**Beitbridge RDC	11	569	12	46	190	20	0	848	828
8**Bikita RDC	23	1072	8	96	516	66	0	1781	1715
8**Bindura Municipality	4	606	1	15	666	14	0	1306	1292
8**Bindura RDC	3	1782	3	3	56	17	0	1864	1847
8**Binga RDC	11	170	15	75	991	54	0	1316	1262
8**Bubi RDC	3	198	1	13	122	15	0	352	337
8**Buhera RDC	7	998	4	44	527	25	0	1605	1580
8**Bulawayo City Council	87	1482	10	413	4702	68	0	6762	6694
8**Bulilima RDC	21	241	8	38	248	18	0	574	556
8**Chaminuka RDC	4	1088	4	9	112	18	0	1235	1217
8**Chegutu Municipality	2	360	2	23	680	12	0	1079	1067
8**Chegutu RDC	20	1431	14	95	706	47	0	2313	2266
8**Chikomba RDC	16	3091	2	25	285	60	0	3479	3419
8**Chimanimani RDC	15	1473	3	102	1114	76	0	2783	2707
8**Chinhoyi Municipality	2	1021	1	14	1192	12	0	2242	2230
8**Chipinge RDC	20	1691	8	49	376	51	0	2195	2144
8**Chipinge Town Council	9	609	3	11	497	11	0	1140	1129
8**Chiredzi RDC	41	1766	25	99	948	93	0	2972	2879
8**Chitungwiza Municipality	4	724	3	44	1606	23	0	2404	2381
8**Chivi RDC	9	817	2	31	465	44	0	1368	1324
8**Gokwe North RDC	11	1262	7	24	175	44	0	1523	1479
8**Gokwe South RDC	20	1351	11	52	433	41	0	1908	1867
8**Goromonzi RDC	8	779	2	20	262	13	0	1084	1071
8**Guruve RDC	16	1559	3	31	320	49	0	1978	1929
8**Gutu RDC	34	1850	10	76	769	75	0	2814	2739
8**Gwanda Municipality	9	280	2	51	326	3	0	671	668
8**Gwanda R.D.C	17	373	21	199	771	15	0	1396	1381
8**Gweru Municipality	4	851	4	40	1498	21	0	2418	2397
8**Harare Municipality	5	1457	7	60	1912	80	0	3521	3441
8**Hurungwe RDC	16	1582	20	78	637	91	0	2424	2333
8**Hwange Local Board	2	142	1	22	617	1	0	785	784
8**Hwange RDC	9	209	3	23	334	16	0	594	578
8**Insiza RDC	3	93	0	33	81	5	0	215	210
8**Kadoma City Council	4	1028	4	18	987	48	0	2089	2041
8**Kariba Municipality	3	448	3	6	242	10	0	712	702
8**Karoi Town Council	0	263	1	11	257	5	0	537	532
8**Kusile RDC	35	495	7	84	296	49	0	966	917
8**Kwekwe Municipality	5	820	4	39	704	28	0	1600	1572
8**Makonde RDC	52	4794	25	33	238	76	0	5218	5142
8**Makoni RDC	11	1870	7	50	652	49	0	2639	2590
8**Mangwe RDC	12	93	7	144	240	13	0	509	496
8**Manyame RDC	12	1130	2	54	1301	41	0	2540	2499
8**Marondera Municipality	0	1038	2	30	1218	16	0	2304	2288
8**Marondera RDC	8	1760	2	7	63	16	0	1856	1840
8**Masvingo Municipality	0	384	0	7	433	11	0	835	824
8**Masvingo RDC	17	2405	5	16	145	36	0	2624	2588
8**Matobo RDC	24	354	11	108	616	24	0	1137	1113
8**Mazowe RDC	23	1550	5	77	813	62	0	2530	2468
8**Mberengwa RDC	19	1105	6	31	217	30	0	1408	1378
8**Mbire RDC	23	1846	5	32	204	64	0	2174	2110
8**Mhondoro-Ngezi RDC	5	740	5	21	273	19	0	1063	1044
8**Mudzi RDC	27	2321	6	59	264	71	1	2748	2677
8**Murewa RDC	12	1753	11	91	654	53	0	2574	2521
8**Mutare Municipality	5	629	4	15	1275	21	0	1949	1928
8**Mutare RDC	6	445	1	17	281	10	0	760	750
8**Mutasa RDC	17	574	7	46	814	36	0	1494	1458
8**Mutoko RDC	7	1433	5	19	264	52	0	1780	1728
8**Muzarabani RDC	7	2037	1	7	139	23	0	2214	2191
8**Mwenezi RDC	15	1718	3	10	80	24	0	1850	1826
8**Nkayi RDC	19	406	3	60	376	17	0	881	864
8**Norton Town Council	1	537	1	18	747	16	0	1320	1304
8**Nyaminyami RDC	18	1443	9	21	251	63	0	1805	1742
8**Nyanga RDC	5	437	5	33	495	19	0	994	975
8**Pfura RDC	25	2638	7	18	166	51	0	2905	2854
8**Redcliff Municipality	1	150	0	8	463	0	0	622	622
8**Runde RDC	3	618	1	21	194	10	0	847	837
8**Rusape Town Council	4	489	0	16	709	18	0	1236	1218
8**Rushinga RDC	6	1504	2	9	56	10	0	1587	1577
8**Ruwa Local Board	0	521	2	14	1319	15	0	1871	1856
8**Sanyati RDC	5	966	3	18	131	18	0	1141	1123
8**Shurugwi Town Council	0	471	0	1	161	9	0	642	633
8**Takawira RDC	2	769	4	23	493	30	0	1321	1291
8**Tongogara RDC	10	982	4	38	280	32	0	1346	1314
8**Tsholotsho RDC	44	513	26	146	635	44	0	1408	1364
8**Umguza RDC	28	968	4	53	238	60	0	1351	1291
8**Umzingwane RDC	9	416	2	55	304	8	0	794	786
8**Victoria Falls Municipality	7	262	3	21	352	9	0	654	645
8**Vungu RDC	27	450	15	127	967	32	0	1618	1586
8**Wedza RDC	17	1527	11	61	493	33	0	2142	2109
8**Zaka RDC	20	1481	10	69	692	66	0	2338	2272
8**Zibagwe RDC	8	1095	7	40	633	31	0	1814	1783
8**Zvataida RDC	19	3363	8	11	123	49	0	3573	3524
8**Zvimba RDC	15	971	11	27	259	20	0	1303	1283
8**Zvishavane Town Council	6	718	4	68	1893	45	1	2734	2689
9**Beitbridge RDC	19	502	14	41	543	22	0	1141	1119
9**Bikita RDC	16	1432	15	66	695	85	0	2309	2224
9**Bindura Municipality	2	530	0	10	571	19	0	1132	1113
9**Bindura RDC	10	1009	6	27	369	34	0	1455	1421
9**Binga RDC	4	685	6	80	1481	132	0	2388	2256
9**Bubi RDC	1	116	1	7	163	10	0	298	288
9**Buhera RDC	3	1050	4	39	899	25	0	2020	1995
9**Bulawayo City Council	78	1304	7	338	4021	38	0	5786	5748
9**Bulilima RDC	20	185	13	132	372	37	0	759	722
9**Chaminuka RDC	11	1533	7	21	249	28	0	1849	1821
9**Chegutu Municipality	2	389	0	28	656	9	0	1084	1075
9**Chegutu RDC	7	1066	8	43	552	33	0	1709	1676
9**Chikomba RDC	3	819	0	10	666	22	0	1520	1498
9**Chimanimani RDC	5	355	2	11	146	4	0	523	519
9**Chinhoyi Municipality	3	232	0	4	256	5	0	500	495
9**Chipinge RDC	15	1344	8	42	275	49	0	1733	1684
9**Chiredzi RDC	7	1095	6	11	124	26	0	1269	1243
9**Chitungwiza Municipality	4	844	0	32	1340	26	0	2246	2220
9**Chivi RDC	5	772	4	20	353	20	0	1174	1154
9**Gokwe North RDC	12	1281	7	43	361	59	0	1763	1704
9**Gokwe South RDC	55	2485	11	108	1007	141	0	3807	3666
9**Goromonzi RDC	5	1054	4	18	248	33	0	1362	1329
9**Guruve RDC	28	1180	2	16	154	36	0	1416	1380
9**Gutu RDC	7	872	4	54	554	22	0	1513	1491
9**Gwanda Municipality	2	199	0	58	306	4	0	569	565
9**Gwanda R.D.C	8	758	2	125	232	15	0	1140	1125
9**Gweru Municipality	5	881	3	27	1524	23	0	2463	2440
9**Harare Municipality	29	5563	5	141	6423	176	1	12337	12161
9**Hurungwe RDC	43	3898	15	96	764	193	0	5009	4816
9**Hwange Local Board	6	203	4	48	1836	22	0	2119	2097
9**Hwange RDC	2	260	5	13	314	15	0	609	594
9**Insiza RDC	25	537	6	93	277	20	0	958	938
9**Kadoma City Council	2	250	1	5	362	19	0	639	620
9**Kariba Municipality	1	331	0	4	341	10	0	687	677
9**Karoi Town Council	2	522	2	16	559	18	0	1119	1101
9**Kusile RDC	4	450	5	41	459	10	0	969	959
9**Kwekwe Municipality	3	551	1	21	518	9	0	1103	1094
9**Makonde RDC	13	2083	8	15	245	27	0	2391	2364
9**Makoni RDC	31	1812	13	30	571	120	0	2577	2457
9**Mangwe RDC	13	136	12	89	345	11	0	606	595
9**Manyame RDC	21	1837	7	38	337	23	1	2263	2240
9**Marondera Municipality	2	835	1	15	837	12	0	1702	1690
9**Marondera RDC	2	188	1	5	68	4	0	268	264
9**Masvingo Municipality	3	715	1	16	917	12	0	1664	1652
9**Masvingo RDC	16	1538	3	33	268	45	0	1903	1858
9**Matobo RDC	7	547	6	57	298	15	0	930	915
9**Mazowe RDC	10	1247	3	41	567	51	0	1919	1868
9**Mberengwa RDC	8	629	3	40	289	22	0	991	969
9**Mbire RDC	14	858	4	37	372	51	0	1336	1285
9**Mhondoro-Ngezi RDC	9	1472	3	12	280	46	0	1822	1776
9**Mudzi RDC	6	2123	1	27	137	24	0	2318	2294
9**Murewa RDC	4	969	3	18	266	22	0	1282	1260
9**Mutare Municipality	3	771	2	18	1569	17	0	2380	2363
9**Mutare RDC	18	966	5	57	518	51	0	1615	1564
9**Mutasa RDC	13	822	6	46	614	50	0	1551	1501
9**Mutoko RDC	3	1129	1	12	97	14	1	1256	1242
9**Muzarabani RDC	9	908	2	3	32	17	0	971	954
9**Mwenezi RDC	36	1932	5	23	175	84	0	2255	2171
9**Nkayi RDC	14	309	5	32	255	34	0	649	615
9**Norton Town Council	1	529	1	11	836	14	0	1392	1378
9**Nyaminyami RDC	8	742	2	19	200	28	0	999	971
9**Nyanga RDC	12	862	5	37	632	39	0	1587	1548
9**Pfura RDC	2	859	1	7	127	9	0	1005	996
9**Redcliff Municipality	0	313	0	12	500	11	0	836	825
9**Runde RDC	5	708	3	20	146	14	0	896	882
9**Rusape Town Council	0	330	0	4	450	9	0	793	784
9**Rushinga RDC	4	1066	1	3	58	37	0	1169	1132
9**Ruwa Local Board	0	479	2	14	1366	19	0	1880	1861
9**Sanyati RDC	5	550	2	11	231	15	0	814	799
9**Shurugwi Town Council	5	276	1	6	138	6	0	432	426
9**Takawira RDC	12	878	17	151	457	33	0	1548	1515
9**Tongogara RDC	7	978	4	37	520	32	0	1578	1546
9**Tsholotsho RDC	53	524	21	103	638	35	0	1374	1339
9**Umguza RDC	24	1549	3	62	288	69	0	1995	1926
9**Umzingwane RDC	8	219	6	51	217	18	0	519	501
9**Victoria Falls Municipality	13	273	1	62	639	6	0	994	988
9**Vungu RDC	3	1298	4	8	346	52	0	1711	1659
9**Wedza RDC	28	1947	2	54	522	41	0	2594	2553
9**Zaka RDC	10	1322	7	37	295	38	0	1709	1671
9**Zibagwe RDC	16	892	6	53	577	17	0	1561	1544
9**Zvataida RDC	15	2774	2	10	137	37	1	2975	2938
9**Zvimba RDC	5	984	3	26	205	14	0	1237	1223
9**Zvishavane Town Council	2	317	0	20	876	6	0	1221	1215
